sample,cultivar,plant_num,leaf,background,damaged,undamaged,leaf_area_px,percent_damage
J1,J,1,10,268627,579,414276,414855,0.13956683660556096
J1,J,1,11,358726,383,414461,414844,0.09232386149974449
J1,J,1,12,373881,159,267242,267401,0.05946125855924248
J1,J,1,13,217118,448,112104,112552,0.3980382401023527
J1,J,1,14,396249,268,379349,379617,0.07059747060853439
J1,J,1,15,321626,38,262730,262768,0.014461426048833952
J1,J,1,16,314972,70,172516,172586,0.04055948918220481
J1,J,1,17,416200,501,215933,216434,0.23147934243233503
J1,J,1,18,408318,248,292200,292448,0.08480140059087428
J1,J,1,19,278421,755,129550,130305,0.5794098461302329
J1,J,1,2,295787,47,287723,287770,0.016332487750634186
J1,J,1,20,184025,60,238654,238714,0.025134679993632544
J1,J,1,21,195027,67,167870,167937,0.03989591334845805
J1,J,1,22,251578,102,111284,111386,0.09157344729140107
J1,J,1,23,291955,5884,242995,248879,2.364201077632102
J1,J,1,24,280622,92,170130,170222,0.054047067946563894
J1,J,1,25,244933,62,273005,273067,0.022705050408874012
J1,J,1,26,351841,11,166148,166159,0.0066201650226590195
J1,J,1,27,328241,468,151251,151719,0.30846499120083837
J1,J,1,28,293563,464,217516,217980,0.21286356546472152
J1,J,1,29,314311,40,197192,197232,0.020280684675914658
J1,J,1,3,407455,330,303908,304238,0.10846771277749656
J1,J,1,30,444080,905,379660,380565,0.23780431726511897
J1,J,1,31,390936,422,289267,289689,0.1456734636109759
J1,J,1,32,561715,221,538680,538901,0.04100938762407195
J1,J,1,33,399190,26,212226,212252,0.012249590109869401
J1,J,1,34,364565,277,246600,246877,0.11220162267039863
J1,J,1,35,427415,89,438476,438565,0.02029345707021764
J1,J,1,36,263898,412,236606,237018,0.1738264604376039
J1,J,1,37,299880,97,200939,201036,0.04825006466503512
J1,J,1,38,187517,398,81958,82356,0.48326776434018165
J1,J,1,39,527107,342,465879,466221,0.07335576904515241
J1,J,1,4,414054,56,413809,413865,0.013530982325154336
J1,J,1,5,227977,86,254437,254523,0.03378869493130287
J1,J,1,6,279588,41,226051,226092,0.018134210852219453
J1,J,1,7,431720,156,373803,373959,0.041715803069320434
J1,J,1,8,347016,4,272668,272672,0.0014669639713648633
J1,J,1,9,221053,0,145243,145243,0
J1,J,1,T,437432,581,356907,357488,0.1625229378328783
J10,J,10,1,666439,20,443844,443864,0.0045058846853991315
J10,J,10,10,331834,19,187195,187214,0.010148813657098294
J10,J,10,11,403894,118,299158,299276,0.039428487416297994
J10,J,10,12,472520,10,230640,230650,0.004335573379579449
J10,J,10,13,471283,45,231842,231887,0.01940600378632696
J10,J,10,14,258900,115,209255,209370,0.05492668481635383
J10,J,10,15,397233,37,357890,357927,0.010337303416618471
J10,J,10,16,512351,1043,527726,528769,0.19725059525047803
J10,J,10,17,604936,522,286918,287440,0.18160311717227942
J10,J,10,18,361488,474,398170,398644,0.11890308144610229
J10,J,10,19,317148,7,202028,202035,0.0034647462073403123
J10,J,10,2,249922,16,142762,142778,0.011206208239364608
J10,J,10,20,364524,1146,320253,321399,0.35656613741797577
J10,J,10,21,256905,44342,14068,58410,75.9150830337271
J10,J,10,22,359476,64,268318,268382,0.023846606702386895
J10,J,10,23,388115,10193,103849,114042,8.937935146700339
J10,J,10,24,568101,3007,541757,544764,0.5519821427260245
J10,J,10,25,609758,194,660918,661112,0.02934449836033834
J10,J,10,26,252660,166,212944,213110,0.07789404532870349
J10,J,10,27,373356,156,371616,371772,0.04196120202704883
J10,J,10,28,574897,81,540830,540911,0.014974737063953221
J10,J,10,29,493867,76,281766,281842,0.026965462918940402
J10,J,10,3,472959,57,353874,353931,0.016104833993066447
J10,J,10,30,575926,187,199596,199783,0.09360155769009375
J10,J,10,31,254956,65,145995,146060,0.044502259345474464
J10,J,10,32,580538,1028,625966,626994,0.16395691186837513
J10,J,10,33,349657,59,393054,393113,0.01500840725185888
J10,J,10,34,563720,2389,591621,594010,0.40218178145149075
J10,J,10,35,433529,487,442472,442959,0.1099424551707946
J10,J,10,36,346190,289,200028,200317,0.14427132994204186
J10,J,10,37,312474,495,228391,228886,0.21626486547888468
J10,J,10,38,412174,162,452012,452174,0.0358269161871315
J10,J,10,39,729394,85,349489,349574,0.02431530949098045
J10,J,10,4,456907,87,369896,369983,0.023514593913774418
J10,J,10,40,327801,104,258420,258524,0.04022837338119478
J10,J,10,41,320421,81,151781,151862,0.0533378988818796
J10,J,10,5,694597,22,132271,132293,0.01662975365287657
J10,J,10,6,411972,121,190132,190253,0.0635995227407715
J10,J,10,7,345348,11524,245353,256877,4.486193781459609
J10,J,10,8,509795,63,393260,393323,0.016017369947854562
J10,J,10,9,378817,5,140226,140231,0.0035655454214831243
J10,J,10,T,594517,53,232320,232373,0.02280815757424486
J11,J,11,1a,344699,742,430617,431359,0.1720144937279621
J11,J,11,10a,539118,166,289797,289963,0.05724868345271638
J11,J,11,11a,430916,177,468690,468867,0.03775057745586702
J11,J,11,12a,542432,350,357001,357351,0.09794291886688437
J11,J,11,13a,195903,151,178351,178502,0.0845928897155214
J11,J,11,14a,216620,31,133205,133236,0.023266984898976252
J11,J,11,15a,122269,21,59122,59143,0.03550716061072316
J11,J,11,16a,445443,1149,635439,636588,0.1804935060038832
J11,J,11,17a,377093,160,468687,468847,0.03412627147022376
J11,J,11,18a,523688,165,322087,322252,0.051202164765463055
J11,J,11,19a,280859,38,163025,163063,0.023303876415863806
J11,J,11,2a,306217,324,469517,469841,0.06895949906457717
J11,J,11,20a,348516,48,385136,385184,0.012461576804851708
J11,J,11,21a,577897,662,623931,624593,0.10598902004985647
J11,J,11,22a,126247,45,185333,185378,0.0242747251561674
J11,J,11,23a,319686,18,414048,414066,0.004347133065743142
J11,J,11,24a,180454,29,129680,129709,0.02235773924708386
J11,J,11,25a,147036,56,163071,163127,0.03432908102276141
J11,J,11,26a,276293,16,321729,321745,0.00497288225147244
J11,J,11,27a,410572,2994,636746,639740,0.4680026260668397
J11,J,11,28a,501628,83,685454,685537,0.01210729690738793
J11,J,11,29a,320226,252,177622,177874,0.14167331931592025
J11,J,11,3a,345700,317,574623,574940,0.05513618812397816
J11,J,11,30a,143102,355,55287,55642,0.6380072607023471
J11,J,11,31a,358108,73,632979,633052,0.011531438175694887
J11,J,11,32a,484850,19,298403,298422,0.006366822821373759
J11,J,11,33a,213234,175,285089,285264,0.06134668237141735
J11,J,11,34a,280398,331,217769,218100,0.15176524530032096
J11,J,11,35a,476954,434,568367,568801,0.07630085038528413
J11,J,11,36a,411806,74,320634,320708,0.023073948888085113
J11,J,11,37a,240724,18,144656,144674,0.012441765624783996
J11,J,11,38a,390421,119,372300,372419,0.03195325694983339
J11,J,11,39a,424034,17,244271,244288,0.006958999214042442
J11,J,11,4a,452839,1138,466663,467801,0.2432658331213486
J11,J,11,5a,469434,758,552937,553695,0.13689847298603022
J11,J,11,6a,303921,65,207356,207421,0.031337232006402434
J11,J,11,7a,345029,1105,392409,393514,0.2808032242817282
J11,J,11,8a,380795,137,194428,194565,0.07041348649551564
J11,J,11,9a,449200,541,379340,379881,0.14241301881378643
J11,J,11,T,601616,138,351924,352062,0.03919764132453943
J11,J,11,1b,345284,150,178006,178156,0.084195873279597655
J11,J,11,10b,298708,84,79208,79292,0.1059375472935479
J11,J,11,11b,212543,105,165352,165457,0.06346059701312123
J11,J,11,12b,508315,450,434975,435425,0.10334730435781134
J11,J,11,13b,231511,939,165596,166535,0.5638454378959378
J11,J,11,14b,366621,2720,377132,379852,0.716068363467877
J11,J,11,15b,690151,50,56272,56322,0.08877525656049146
J11,J,11,16b,140295,30,87553,87583,0.034253222657365016
J11,J,11,17b,258798,420,92350,92770,0.4527325644065969
J11,J,11,18b,462721,722,484197,484919,0.1488908456876303
J11,J,11,19b,282962,34,86226,86260,0.03941571991653142
J11,J,11,2b,184156,48,76916,76964,0.062366820851307105
J11,J,11,20b,271545,79,97598,97677,0.08087881486941655
J11,J,11,21b,284041,26,85155,85181,0.030523238750425563
J11,J,11,22b,314840,931,205893,206824,0.4501411828414497
J11,J,11,23b,420210,300,459690,459990,0.06521880910454575
J11,J,11,24b,224049,140,219921,220061,0.06361872389928247
J11,J,11,25b,251823,36,192251,192287,0.01872201448875899
J11,J,11,26b,484301,31,381819,381850,0.008118371088123608
J11,J,11,27b,276615,69,121892,121961,0.05657546264789564
J11,J,11,28b,370284,289,457523,457812,0.06312634880693385
J11,J,11,29b,407355,1000,636845,637845,0.15677790058713323
J11,J,11,3b,101930,20,68552,68572,0.029166423613136556
J11,J,11,30b,386437,110,217732,217842,0.05049531311684616
J11,J,11,31b,326336,61,277882,277943,0.021946945956545047
J11,J,11,32b,428695,46,412093,412139,0.011161282965213192
J11,J,11,4b,222388,555,177977,178532,0.31086863979566687
J11,J,11,5b,290336,698,269742,270440,0.2580979145096879
J11,J,11,6b,142943,285,56420,56705,0.5026011815536549
J11,J,11,7b,391447,43,214144,214187,0.02007591497149687
J11,J,11,8b,292204,252,353129,353381,0.07131113444129707
J11,J,11,9b,367420,79,188341,188420,0.04192760853412589
J12,J,12,1,302569,175,304256,304431,0.05748429036464749
J12,J,12,10,400254,426,481301,481727,0.08843182964625192
J12,J,12,11,192970,101,127804,127905,0.078964856729604
J12,J,12,12,411733,256,444389,444645,0.05757401972359972
J12,J,12,13,714559,19,141800,141819,0.013397358604982408
J12,J,12,14,519251,359,336768,337127,0.10648805939601395
J12,J,12,15,306896,261,155550,155811,0.16751063788821072
J12,J,12,16,287703,51,174953,175004,0.029142191035633473
J12,J,12,17,282212,92,311824,311916,0.029495120481155185
J12,J,12,18,421156,27,172945,172972,0.015609462803228268
J12,J,12,19,246503,172,97068,97240,0.17688194158782394
J12,J,12,2,346483,130,260387,260517,0.049900774229704785
J12,J,12,20,343152,24,225224,225248,0.010654922574229293
J12,J,12,21,413217,173,155010,155183,0.11148128338799998
J12,J,12,22,279575,351,288474,288825,0.12152687613606855
J12,J,12,23,440360,21,128019,128040,0.01640112464854733
J12,J,12,24,287377,109,280914,281023,0.03878686086192234
J12,J,12,25,449494,160,436618,436778,0.03663188164239042
J12,J,12,26,288443,140,311907,312047,0.04486503635670268
J12,J,12,27,229806,9,70849,70858,0.012701459256541252
J12,J,12,28,312839,712,197469,198181,0.3592675382604791
J12,J,12,29,346192,88,377488,377576,0.02330656609530267
J12,J,12,3,392396,638,213966,214604,0.2972917559784533
J12,J,12,30,319914,84,169264,169348,0.04960200297612018
J12,J,12,31,409807,5627,243696,249323,2.256911716929445
J12,J,12,32,577427,3394,78309,81703,4.1540702299793155
J12,J,12,33,329027,190,329913,330103,0.057557792567774296
J12,J,12,34,283207,692,414851,415543,0.1665290956651899
J12,J,12,35,253803,61,85174,85235,0.07156684460608906
J12,J,12,36,163055,122,234743,234865,0.05194473420901369
J12,J,12,4,181713,38,67305,67343,0.056427542580520615
J12,J,12,5,343905,170,214885,215055,0.07904954546511357
J12,J,12,6,389708,187,383270,383457,0.048766876077369826
J12,J,12,7,233302,32,130783,130815,0.024462026526010015
J12,J,12,8,275440,11,88666,88677,0.012404569392288869
J12,J,12,9,275691,99,88327,88426,0.11195802139642187
J13,J,13,1,617386,383,288081,288464,0.1327722003438904
J13,J,13,10,285360,85,178193,178278,0.047678345056597
J13,J,13,11,535426,1139,477570,478709,0.23793160354202658
J13,J,13,12,284871,16,220153,220169,0.00726714478423393
J13,J,13,13,340498,5,164537,164542,0.0030387378298549913
J13,J,13,14,383679,1133,459042,460175,0.24621068071929159
J13,J,13,15,500593,173,403986,404159,0.04280493568125416
J13,J,13,16,431828,231,277871,278102,0.08306304880942963
J13,J,13,17,316031,0,152031,152031,0
J13,J,13,18,314893,19,153150,153169,0.012404598841802192
J13,J,13,19,312161,38,288745,288783,0.01315866931225176
J13,J,13,2,584808,69,320973,321042,0.02149251499803764
J13,J,13,20,417979,330,182635,182965,0.1803623643866313
J13,J,13,21,371392,23,229529,229552,0.01001951627517948
J13,J,13,22,519623,553,626118,626671,0.08824407065270293
J13,J,13,23,589311,29,369835,369864,0.007840719832154522
J13,J,13,24,175120,173,78207,78380,0.22071957131921408
J13,J,13,25,471118,658,314804,315462,0.20858296720365688
J13,J,13,26,647411,910,569211,570121,0.1596152395719505
J13,J,13,27,250813,7,124438,124445,0.005624974888504962
J13,J,13,28,263250,241,229475,229716,0.10491215239687265
J13,J,13,29,289564,524,202878,203402,0.25761791919450155
J13,J,13,3,211257,113,129438,129551,0.0872243363617417
J13,J,13,30,242812,35,195498,195533,0.017899791850991904
J13,J,13,31,301296,92,136957,137049,0.06712927493086415
J13,J,13,32,468153,61,246896,246957,0.024700656389573895
J13,J,13,33,545552,83,169475,169558,0.0489508014956534
J13,J,13,34,394618,39,320453,320492,0.012168790484629882
J13,J,13,35,482002,81,233027,233108,0.03474784220189783
J13,J,13,36,565733,156,149221,149377,0.10443374816738854
J13,J,13,37,654303,15463,45344,60807,25.429638035094644
J13,J,13,38,491342,6157,217611,223768,2.7515104930106182
J13,J,13,39,696781,139,548050,548189,0.02535621838453526
J13,J,13,4,222062,36,118710,118746,0.03031681067151736
J13,J,13,5,443851,295,250850,251145,0.11746202393039878
J13,J,13,6,452901,9,242086,242095,0.0037175488960945087
J13,J,13,7,208062,12,65922,65934,0.0182000182000182
J13,J,13,8,226629,81,211186,211267,0.03834010990831507
J13,J,13,9,151397,42,72639,72681,0.057786766830395846
J14,J,14,1,353797,2305,354280,356585,0.6464096919388084
J14,J,14,10,457558,28,524824,524852,0.005334837249357915
J14,J,14,12,190716,295,185794,186089,0.1585262965570238
J14,J,14,13,188370,67,96677,96744,0.0692549408748863
J14,J,14,14,629846,29,630461,630490,0.004599597138733366
J14,J,14,15,301389,53,259087,259140,0.02045226518484217
J14,J,14,16,241854,30,164790,164820,0.018201674554058973
J14,J,14,17,600799,53,248353,248406,0.021336038581998822
J14,J,14,18,212460,41,165136,165177,0.0248218577647009
J14,J,14,19,258828,103,354253,354356,0.029066814164286765
J14,J,14,2,509554,335,200493,200828,0.16680940904654729
J14,J,14,20,364024,804,248356,249160,0.32268421897575855
J14,J,14,21,480271,858,511919,512777,0.16732419745815433
J14,J,14,22,203062,1,114281,114282,8.750284384242488e-4
J14,J,14,23,372789,289,192737,193026,0.1497207630060199
J14,J,14,24,324513,185,108280,108465,0.1705619324205965
J14,J,14,25,243664,429,206567,206996,0.20725038164988696
J14,J,14,26,164086,25,168767,168792,0.014811128489501871
J14,J,14,27,301546,37,266433,266470,0.013885240364769015
J14,J,14,28,266754,25,301237,301262,0.008298424627068797
J14,J,14,29,187066,373,173461,173834,0.2145725232117998
J14,J,14,3,328815,35,381532,381567,0.009172700993534557
J14,J,14,30,324970,73,401958,402031,0.018157803751452
J14,J,14,31,378186,55,348760,348815,0.015767670541691155
J14,J,14,33,515946,102,506064,506166,0.020151491803084363
J14,J,14,34,218793,16,227614,227630,0.007028950489829987
J14,J,14,35,463477,620,625928,626548,0.09895490848267012
J14,J,14,36,166705,36,117704,117740,0.030575845082384916
J14,J,14,37,269075,94,322191,322285,0.029166731309244923
J14,J,14,38,316103,225,240942,241167,0.09329634651507047
J14,J,14,39,299942,100,225054,225154,0.0444140454977482
J14,J,14,4,222203,34,185920,185954,0.018284091764629962
J14,J,14,40,104397,48,130230,130278,0.03684428683277299
J14,J,14,41,367890,201,436454,436655,0.04603176420744066
J14,J,14,42,269451,40,308361,308401,0.01297012655600987
J14,J,14,43,265155,141,173499,173640,0.08120248790601245
J14,J,14,44,301256,34,137505,137539,0.024720261162288513
J14,J,14,45,360970,158,339798,339956,0.04647660285448705
J14,J,14,46,290246,54,158148,158202,0.03413357606098532
J14,J,14,47,299617,159,148672,148831,0.10683258192177704
J14,J,14,48,254718,435,339357,339792,0.12801949427885295
J14,J,14,49,340534,1810,321784,323594,0.5593428802759013
J14,J,14,5,161078,9,91651,91660,0.009818895919703252
J14,J,14,50,364188,3128,296812,299940,1.0428752417150098
J14,J,14,51,506276,45,157807,157852,0.02850771608848795
J14,J,14,6,485508,16,356828,356844,0.004483752003676677
J14,J,14,7,397748,1840,249456,251296,0.7322042531516618
J14,J,14,8,310688,126,375874,376000,0.03351063829787234
J14,J,14,9,255827,90,207477,207567,0.04335949356111521
J14,J,14,T,469482,16,191166,191182,0.008368988712326475
J15,J,15,1,420988,92,563162,563254,0.016333661190155772
J15,J,15,10,572993,96,160861,160957,0.059643258758550415
J15,J,15,11,494928,69,142203,142272,0.04849865047233468
J15,J,15,12,412738,44,320058,320102,0.013745618584076327
J15,J,15,13,381925,103,256572,256675,0.040128567254309924
J15,J,15,14,392670,51,245879,245930,0.020737608262513724
J15,J,15,15,186066,4,125585,125589,0.0031849923162060373
J15,J,15,16,189173,8,122474,122482,0.006531571986087751
J15,J,15,17,599587,123,410243,410366,0.029973243397357484
J15,J,15,18,398642,39,238574,238613,0.016344457343061777
J15,J,15,19,433417,96,203742,203838,0.04709622347158037
J15,J,15,2,644359,390,408051,408441,0.09548502721323275
J15,J,15,20,397751,121,406521,406642,0.029755903226917044
J15,J,15,21,514436,201,409875,410076,0.04901530448014514
J15,J,15,22,554978,78,125987,126065,0.06187284337444968
J15,J,15,23,735587,514,315180,315694,0.16281589133781446
J15,J,15,24,590310,152,458314,458466,0.03315403977612298
J15,J,15,25,726803,171,321802,321973,0.05311004338873135
J15,J,15,26,723634,68,325074,325142,0.020913939140437102
J15,J,15,27,514867,840,533069,533909,0.1573301817350897
J15,J,15,28,522941,212,525623,525835,0.04031682942367853
J15,J,15,29,600505,201,154187,154388,0.1301914656579527
J15,J,15,3,277133,11,209936,209947,0.005239417567290792
J15,J,15,30,651904,0,102989,102989,0
J15,J,15,31,329188,122,208154,208276,0.0585761201482648
J15,J,15,32,251158,12,58430,58442,0.020533178193764757
J15,J,15,33,306657,35,302554,302589,0.011566844796076526
J15,J,15,34,383019,298,225929,226227,0.1317260981226821
J15,J,15,35,508588,804,237200,238004,0.3378094485806961
J15,J,15,36,500765,97,245730,245827,0.03945864368031177
J15,J,15,37,467341,53,279198,279251,0.01897934116619099
J15,J,15,4,340145,62,146873,146935,0.042195528635110766
J15,J,15,5,291271,273,195536,195809,0.13942157919196768
J15,J,15,6,436338,82,316340,316422,0.025914759403581292
J15,J,15,7,424125,187,156568,156755,0.11929444036872826
J15,J,15,8,621935,61,299829,299890,0.020340791623595318
J15,J,15,9,497508,106,204101,204207,0.05190811284627853
J15,J,15,T,404034,533,329383,329916,0.16155627493058838
J16,J,16,1,415694,92,353126,353218,0.02604623773420381
J16,J,16,10,437667,36,149932,149968,0.024005121092499734
J16,J,16,11,305568,23,133801,133824,0.01718675274988044
J16,J,16,12,231336,914,207142,208056,0.43930480255315874
J16,J,16,13,273541,14736,254551,269287,5.472228514558816
J16,J,16,14,370197,42,316745,316787,0.013258119809209342
J16,J,16,15,196133,2343,211654,213997,1.0948751618013337
J16,J,16,16,362798,37,213603,213640,0.017318854147163453
J16,J,16,17,418374,30,158034,158064,0.018979653811114487
J16,J,16,18,297711,124,278603,278727,0.04448797568947393
J16,J,16,19,298522,616,277300,277916,0.22164970710574416
J16,J,16,2,244151,45,215488,215533,0.020878473366027477
J16,J,16,20,233764,4,124540,124544,0.003211716341212744
J16,J,16,21,254746,300,293854,294154,0.10198739435805734
J16,J,16,22,285462,77,492061,492138,0.015646017986824835
J16,J,16,23,154776,9,91891,91900,0.009793253536452665
J16,J,16,24,247412,240,289710,289950,0.08277289187790998
J16,J,16,25,460247,38,318791,318829,0.011918614680596809
J16,J,16,26,558472,26,220578,220604,0.011785824373084805
J16,J,16,27,556034,146,222896,223042,0.06545852350678347
J16,J,16,28,226985,5,192530,192535,0.0025969304282338276
J16,J,16,29,352977,77,338728,338805,0.02272693732382934
J16,J,16,3,296775,127,323963,324090,0.039186645684840635
J16,J,16,30,269969,1,187930,187931,5.321101893780163e-4
J16,J,16,31,382445,2439,364025,366464,0.665549685644429
J16,J,16,32,261793,751,275664,276415,0.27169292549246604
J16,J,16,33,144960,13,59923,59936,0.021689802455953016
J16,J,16,34,251205,41,130633,130674,0.03137579013422716
J16,J,16,35,251387,139,310494,310633,0.0447473384991292
J16,J,16,37,246357,1229,136524,137753,0.8921765769166552
J16,J,16,38,156886,21,216839,216860,0.009683666881859263
J16,J,16,39,526140,112,422381,422493,0.026509314947229894
J16,J,16,4,337032,639,348433,349072,0.1830567905761562
J16,J,16,40,169173,53,105062,105115,0.05042096751177282
J16,J,16,41,249483,885,313522,314407,0.28148228251915514
J16,J,16,42,233392,94,178339,178433,0.052680838185761594
J16,J,16,43,499209,107,314479,314586,0.03401295671136033
J16,J,16,44,301508,55,154137,154192,0.035669814257549025
J16,J,16,45,318431,544,333325,333869,0.16293815837948417
J16,J,16,46,549013,10,103277,103287,0.009681760531335017
J16,J,16,47,142880,30,167946,167976,0.017859694242034575
J16,J,16,48,309052,276,239123,239399,0.11528870212490444
J16,J,16,49,330811,218,510975,511193,0.04264534138769506
J16,J,16,5,371100,545,405855,406400,0.13410433070866143
J16,J,16,6,574233,201,203066,203267,0.09888471812935695
J16,J,16,7,414146,21,363333,363354,0.005779487772255156
J16,J,16,8,279612,191,259930,260121,0.07342736649482356
J16,J,16,9,318116,1713,267806,269519,0.6355767125879809
J16,J,16,T,366034,1244,338347,339591,0.36632301798339767
J17,J,17,1,635167,89,378444,378533,0.023511820633868117
J17,J,17,10,417153,280,239342,239622,0.11685070652945055
J17,J,17,11,593002,284,618726,619010,0.045879711151677674
J17,J,17,12,189920,15,114484,114499,0.013100551096516129
J17,J,17,13,224922,19,179456,179475,0.010586432650787018
J17,J,17,14,261370,12,129945,129957,0.009233823495463884
J17,J,17,15,305003,6,132918,132924,0.004513857542655954
J17,J,17,16,304869,3,133055,133058,0.002254655864359903
J17,J,17,17,312544,31,125352,125383,0.024724244913584777
J17,J,17,18,282682,326,154919,155245,0.20999065992463525
J17,J,17,19,331281,475,265619,266094,0.17850834667448345
J17,J,17,2,509974,51,171515,171566,0.029726169520767516
J17,J,17,20,208838,7,205842,205849,0.0034005508892440573
J17,J,17,21,693945,389,327362,327751,0.11868766228020661
J17,J,17,22,385636,29,222095,222124,0.013055770650627577
J17,J,17,23,494562,375,511131,511506,0.0733129230155658
J17,J,17,24,503116,74,579384,579458,0.0127705545527027
J17,J,17,25,516689,39,369048,369087,0.01056661437547245
J17,J,17,26,585487,49,300240,300289,0.016317614031816016
J17,J,17,27,474394,36,198330,198366,0.018148271377151325
J17,J,17,28,467995,527,204238,204765,0.25736820257368204
J17,J,17,29,531451,13,141296,141309,0.009199697117664125
J17,J,17,3,467363,61,267423,267484,0.02280510236126273
J17,J,17,30,391738,13,281009,281022,0.004625972343802265
J17,J,17,31,532569,25,140166,140191,0.01783281380402451
J17,J,17,32,482121,280,190359,190639,0.1468744590561218
J17,J,17,33,429621,17502,225637,243139,7.198351560218641
J17,J,17,34,495869,11466,97593,109059,10.51357522075207
J17,J,17,35,658506,124,445094,445218,0.02785152442174395
J17,J,17,36,727884,10140,513176,523316,1.93764379457154
J17,J,17,37,459467,113,347439,347552,0.032513120338827
J17,J,17,38,556568,25,250426,250451,0.009981992485556057
J17,J,17,39,495990,128,310901,311029,0.04115371878506506
J17,J,17,4,418173,11,316663,316674,0.003473603769175872
J17,J,17,40,766640,381,557523,557904,0.06829131893659124
J17,J,17,5,579091,1950,543302,545252,0.35763280098009725
J17,J,17,6,283518,160,239618,239778,0.0667283904278124
J17,J,17,7,464322,271,299471,299742,0.09041108686803985
J17,J,17,8,462758,28,301278,301306,0.009292878336309268
J17,J,17,9,591375,226,610301,610527,0.03701719989451736
J17,J,17,T,472794,4,291266,291270,0.0013732962543344662
J18,J,18,1,282753,157,248280,248437,0.06319509573855746
J18,J,18,10,523074,35,59971,60006,0.058327500583275
J18,J,18,11,543166,2328,328325,330653,0.7040613573746496
J18,J,18,12,331364,51,152974,153025,0.033327887600065345
J18,J,18,13,347240,54,137095,137149,0.03937323640711927
J18,J,18,14,849773,2166,374941,377107,0.5743727907463929
J18,J,18,15,279265,261,72322,72583,0.3595883333562956
J18,J,18,16,577977,103,570289,570392,0.0180577567707822
J18,J,18,17,258436,80,131202,131282,0.06093752380372024
J18,J,18,18,205264,113,223431,223544,0.050549332569874386
J18,J,18,19,497344,51,314689,314740,0.016203850797483637
J18,J,18,2,405351,67,125772,125839,0.053242635430987215
J18,J,18,20,392285,205,419594,419799,0.048832893837288796
J18,J,18,21,467159,85,389654,389739,0.02180946736149064
J18,J,18,22,217227,42,140482,140524,0.02988813298795935
J18,J,18,23,409596,105,180264,180369,0.05821399464431249
J18,J,18,24,439776,38,150151,150189,0.025301453501920913
J18,J,18,25,520251,37,368192,368229,0.010048095071273582
J18,J,18,26,343810,248,140790,141038,0.17583913555212072
J18,J,18,27,295962,5,188881,188886,0.002647099308577661
J18,J,18,28,361490,94,266232,266326,0.035295089476806624
J18,J,18,29,301432,32,115393,115425,0.02772363006281135
J18,J,18,3,546534,107,218383,218490,0.04897249302027553
J18,J,18,30,589996,22,420194,420216,0.005235402745254821
J18,J,18,31,385384,844,207772,208616,0.40457107796142194
J18,J,18,32,916522,16,535199,535215,0.002989452836710481
J18,J,18,33,548699,697,310605,311302,0.22389833666343292
J18,J,18,4,591426,9,173589,173598,0.005184391525247987
J18,J,18,5,658946,43,106035,106078,0.0405362092045476
J18,J,18,6,606829,258,462289,462547,0.05577811552123352
J18,J,18,7,381483,60,201537,201597,0.029762347653982946
J18,J,18,8,502468,165,80447,80612,0.20468416612911228
J18,J,18,9,388021,459,194600,195059,0.2353134179914795
J18,J,18,T,594157,1067,459549,460616,0.23164631710578878
J19,J,19,1,524690,17,305775,305792,0.005559334449560485
J19,J,19,10,351945,70,286955,287025,0.024388119501785557
J19,J,19,11,493039,68,145863,145931,0.04659736450788386
J19,J,19,12,489120,1412,316799,318211,0.44373073212428227
J19,J,19,13,526381,47,157749,157796,0.02978529240284925
J19,J,19,14,618490,30,65657,65687,0.045671137363557476
J19,J,19,15,489940,31,194206,194237,0.015959884059164833
J19,J,19,16,492048,64,271989,272053,0.02352482788280225
J19,J,19,17,525830,155,238116,238271,0.0650519786293758
J19,J,19,18,558324,25,377851,377876,0.0066159269178248945
J19,J,19,19,768527,18,167655,167673,0.010735180977259309
J19,J,19,2,669622,0,160860,160860,0
J19,J,19,20,605115,217,330868,331085,0.06554208133862904
J19,J,19,21,338392,35,94113,94148,0.03717551089773548
J19,J,19,22,365909,22,256889,256911,0.00856327677678262
J19,J,19,23,411291,37,211492,211529,0.01749169144656288
J19,J,19,24,420052,84,408089,408173,0.020579509178706087
J19,J,19,25,397278,16,241949,241965,0.006612526605087514
J19,J,19,26,420553,6,167981,167987,0.003571704953359486
J19,J,19,27,435883,533,152124,152657,0.34914874522622613
J19,J,19,28,621019,4046,661584,665630,0.607845199284888
J19,J,19,29,346477,0,216348,216348,0
J19,J,19,3,433514,130,408972,409102,0.03177691627027001
J19,J,19,30,457960,33,104832,104865,0.031469031612072665
J19,J,19,31,336979,30,225816,225846,0.013283387795223294
J19,J,19,32,393988,4,168833,168837,0.002369148942471141
J19,J,19,33,355301,26,89681,89707,0.028983245454646797
J19,J,19,34,373837,4004,285487,289491,1.3831172644399998
J19,J,19,35,445418,22,164342,164364,0.013384926139543937
J19,J,19,36,327481,8,282293,282301,0.0028338546445106465
J19,J,19,4,622058,15,220543,220558,0.0068009321811042895
J19,J,19,5,422797,5,240028,240033,0.002083046914382606
J19,J,19,6,492990,341,579757,580098,0.05878317111936259
J19,J,19,7,417994,15,166051,166066,0.009032553322173112
J19,J,19,8,521040,213,62807,63020,0.33798794033640117
J19,J,19,9,342046,414,241600,242014,0.1710644838728338
J19,J,19,T,713519,46,491507,491553,0.00935809566821889
J2,J,2,1,496937,44,270989,271033,0.016234185505086096
J2,J,2,10,287003,219,105508,105727,0.2071372497091566
J2,J,2,11,375272,13,133955,133968,0.009703809865042398
J2,J,2,12,255649,198,141966,142164,0.1392757660167131
J2,J,2,13,260764,18,137031,137049,0.013133988573429942
J2,J,2,14,493387,1084,435623,436707,0.2482213474938574
J2,J,2,15,441550,2717,485827,488544,0.556142333136831
J2,J,2,16,230678,39,116635,116674,0.0334264703361503
J2,J,2,17,282035,73,269916,269989,0.027038138590831477
J2,J,2,18,369558,44,310441,310485,0.01417137703914843
J2,J,2,19,212125,19,231404,231423,0.008210074193144155
J2,J,2,2,303656,2510,537354,539864,0.46493190877702534
J2,J,2,20,262766,120,75222,75342,0.15927371187385522
J2,J,2,21,306146,119,294887,295006,0.04033816261364176
J2,J,2,22,328396,16,335132,335148,0.0047740102879921704
J2,J,2,23,248794,107,105739,105846,0.10109026321259189
J2,J,2,24,546104,335,449717,450052,0.07443584296925689
J2,J,2,25,415487,51,374139,374190,0.013629439589513348
J2,J,2,26,353018,26,195946,195972,0.013267201436939971
J2,J,2,27,368500,28,180462,180490,0.015513324837941161
J2,J,2,28,371503,89,380153,380242,0.02340614661189453
J2,J,2,29,369721,205,381819,382024,0.05366155005968211
J2,J,2,3,239234,75,218046,218121,0.03438458470298596
J2,J,2,30,465896,8,285841,285849,0.0027986804221809417
J2,J,2,31,435116,898,436211,437109,0.2054407481886669
J2,J,2,32,325477,66,260512,260578,0.025328308606252254
J2,J,2,33,637745,1420,639174,640594,0.2216692632150785
J2,J,2,4,477494,2269,432015,434284,0.5224691676414512
J2,J,2,5,576462,33,335283,335316,0.009841462978205633
J2,J,2,6,710295,130,201353,201483,0.06452157253961872
J2,J,2,7,310471,51,164308,164359,0.031029636344830525
J2,J,2,8,332223,180,177897,178077,0.10107986994390067
J2,J,2,9,502278,177,462339,462516,0.03826894637158498
J2,J,2,T,559507,2669,472410,475079,0.5618013004152994
J20,J,20,1,543027,25,292025,292050,0.008560178051703475
J20,J,20,10,248827,78,178235,178313,0.043743305311446726
J20,J,20,11,266681,44,236610,236654,0.01859254438969973
J20,J,20,12,390538,57,243462,243519,0.023406797826863612
J20,J,20,13,486122,5,147930,147935,0.0033798627775712305
J20,J,20,14,426181,26,207850,207876,0.012507456368219516
J20,J,20,15,482983,158,386211,386369,0.04089354994836542
J20,J,20,16,481274,12,291589,291601,0.004115212224923783
J20,J,20,17,592024,17,180834,180851,0.00940000331764823
J20,J,20,18,272374,36,148087,148123,0.0243041256253249
J20,J,20,19,392204,46,315765,315811,0.014565673773237791
J20,J,20,2,639885,3,195189,195192,0.0015369482355834256
J20,J,20,20,355514,100,352401,352501,0.02836871384762029
J20,J,20,21,452028,51,429004,429055,0.011886587966577713
J20,J,20,22,248288,1266,185006,186272,0.6796512626696444
J20,J,20,23,377738,32,268777,268809,0.011904363321168562
J20,J,20,24,425747,5,220795,220800,0.0022644927536231885
J20,J,20,25,467699,689,178159,178848,0.38524333512256215
J20,J,20,26,499283,75,147189,147264,0.050928943937418515
J20,J,20,27,313883,84,332580,332664,0.0252507034124522
J20,J,20,28,397266,66,249215,249281,0.026476145394153584
J20,J,20,29,396022,11,250514,250525,0.0043907793633369925
J20,J,20,3,367917,29,313966,313995,0.009235815856940397
J20,J,20,30,470436,41,176070,176111,0.02328077178597589
J20,J,20,31,518632,5,127910,127915,0.003908845717859516
J20,J,20,32,323575,4,322968,322972,0.0012384974548877302
J20,J,20,33,458731,5,187811,187816,0.0026621800059632834
J20,J,20,34,404400,306,241841,242147,0.126369519341557
J20,J,20,35,304232,39,342276,342315,0.01139301520529337
J20,J,20,36,385299,115,429910,430025,0.02674263124236963
J20,J,20,4,593731,1412,86769,88181,1.6012519703791066
J20,J,20,5,702818,446,471584,472030,0.09448551998813635
J20,J,20,6,278095,19,149026,149045,0.012747827837230366
J20,J,20,7,252204,64,174872,174936,0.036584808158412224
J20,J,20,8,298840,13,128287,128300,0.010132501948558068
J20,J,20,9,332822,39,94279,94318,0.0413494773001972
J20,J,20,T,597052,1352,438269,439621,0.3075376290031641
J21,J,21,1,635630,320,554085,554405,0.05771953716146138
J21,J,21,10,246655,730,110461,111191,0.6565279563993488
J21,J,21,11,250151,67,199734,199801,0.03353336569887038
J21,J,21,12,443265,7,356732,356739,0.0019622188771062318
J21,J,21,13,249574,195,119864,120059,0.1624201434294805
J21,J,21,14,477065,20,359565,359585,0.005561967267822629
J21,J,21,15,451916,892,405592,406484,0.2194428316981726
J21,J,21,16,239553,35,136376,136411,0.025657754873140728
J21,J,21,17,408397,257,263832,264089,0.09731567766927059
J21,J,21,18,419698,45,461921,461966,0.009740976608668172
J21,J,21,19,243780,3830,278710,282540,1.3555602746513769
J21,J,21,2,441514,112,215646,215758,0.051910010289305614
J21,J,21,20,166935,32,213617,213649,0.014977837481102181
J21,J,21,21,270693,14,227053,227067,0.006165581083997234
J21,J,21,22,322857,54,174849,174903,0.03087425601619183
J21,J,21,23,153485,26,113525,113551,0.022897200376923145
J21,J,21,24,183962,18,212052,212070,0.008487763474324516
J21,J,21,25,184364,3,211665,211668,0.0014173139066840524
J21,J,21,26,304219,42,303359,303401,0.013843065777634219
J21,J,21,27,312969,42,294609,294651,0.014254151521630676
J21,J,21,28,406911,17,320128,320145,0.005310093863718003
J21,J,21,29,180247,92,161877,161969,0.056800992782569504
J21,J,21,3,371454,206,307529,307735,0.0669407119762133
J21,J,21,30,190618,28,54980,55008,0.05090168702734148
J21,J,21,31,335576,33,180007,180040,0.018329260164407907
J21,J,21,32,263420,24,252172,252196,0.009516407873241447
J21,J,21,33,522820,49,421267,421316,0.011630225294078554
J21,J,21,34,235343,23,216409,216432,0.01062689435942929
J21,J,21,35,242205,30,155990,156020,0.01922830406358159
J21,J,21,36,278899,104,119222,119326,0.08715619395605317
J21,J,21,37,355282,177,305216,305393,0.05795810643989876
J21,J,21,38,427031,64,233580,233644,0.027392100802930953
J21,J,21,39,153213,17,94688,94705,0.017950477799482605
J21,J,21,4,432720,15,178235,178250,0.008415147265077139
J21,J,21,40,284484,101,176171,176272,0.05729781247163474
J21,J,21,41,226592,29,109173,109202,0.026556290177835572
J21,J,21,42,216082,31,202555,202586,0.015302143287295272
J21,J,21,43,479012,75,433263,433338,0.017307505919167025
J21,J,21,44,235656,24,182172,182196,0.013172627280511098
J21,J,21,45,279405,80,225307,225387,0.035494505006943615
J21,J,21,46,555604,732,439664,440396,0.1662140437242845
J21,J,21,47,499824,66,348930,348996,0.01891139153457346
J21,J,21,48,428668,19,253489,253508,0.0074948325102166405
J21,J,21,49,205406,213,275231,275444,0.07732969314996878
J21,J,21,5,411679,517,64642,65159,0.7934437299528845
J21,J,21,50,240655,326,316886,317212,0.10277038699670882
J21,J,21,51,273725,49,237510,237559,0.020626454901729672
J21,J,21,52,337493,4,179461,179465,0.0022288468503607944
J21,J,21,6,598497,72,507801,507873,0.01417677253959159
J21,J,21,7,829416,4942,272012,276954,1.7844118517876615
J21,J,21,8,281581,1149,260354,261503,0.43938310459153435
J21,J,21,9,245154,170,112522,112692,0.15085365420792957
J21,J,21,T,624406,335,267871,268206,0.12490399170786634
J22,J,22,1a,915707,156,711907,712063,0.021908173855403244
J22,J,22,10a,354252,229,230642,230871,0.09918959072382413
J22,J,22,11a,202000,3,153384,153387,0.001955837196111796
J22,J,22,12a,325154,57,136549,136606,0.04172583927499524
J22,J,22,13a,554916,586,404258,404844,0.14474711246801236
J22,J,22,14a,504268,49,289944,289993,0.01689695958178301
J22,J,22,15a,181758,90,133192,133282,0.06752599750904098
J22,J,22,16a,218711,996,107532,108528,0.9177355152587351
J22,J,22,17a,234373,156,153439,153595,0.10156580617858654
J22,J,22,18a,540551,571,572823,573394,0.09958248603926793
J22,J,22,19a,374153,1139,380726,381865,0.2982729498644809
J22,J,22,2a,1065053,304,562413,562717,0.05402360333880085
J22,J,22,20a,483159,642,416611,417253,0.15386348330629138
J22,J,22,21a,230850,75,186051,186126,0.04029528383997937
J22,J,22,22a,414267,60,98823,98883,0.060677770698704524
J22,J,22,23a,532031,87,211951,212038,0.04103038134673973
J22,J,22,24a,457024,114,180662,180776,0.06306146833650485
J22,J,22,25a,641231,887,584338,585225,0.15156563714810542
J22,J,22,26a,372053,334,311268,311602,0.10718801548128704
J22,J,22,27a,451953,394,385408,385802,0.10212492418390781
J22,J,22,28a,409201,88,314539,314627,0.027969627527198875
J22,J,22,29a,448542,57,247726,247783,0.023003999467275802
J22,J,22,3a,1049537,289,577944,578233,0.04997985241243581
J22,J,22,30a,504623,596,443590,444186,0.13417802452125913
J22,J,22,31a,294572,246,242254,242500,0.10144329896907217
J22,J,22,33a,549822,9,164305,164314,0.005477317818323454
J22,J,22,34a,206543,66,113619,113685,0.05805515239477503
J22,J,22,35a,502824,245,299095,299340,0.08184672947150397
J22,J,22,36a,482403,143,328165,328308,0.043556660209315645
J22,J,22,37a,460860,390,338850,339240,0.11496285815351963
J22,J,22,38a,310739,65,78662,78727,0.08256379641038017
J22,J,22,39a,466863,103,230796,230899,0.04460824862818808
J22,J,22,4a,434535,8,354817,354825,0.0022546325653491155
J22,J,22,40a,583158,52,154505,154557,0.03364454537808058
J22,J,22,41a,547820,308,655703,656011,0.046950432233605836
J22,J,22,42a,624651,205,395848,396053,0.051760749192658564
J22,J,22,43a,722888,506,667646,668152,0.07573127072881619
J22,J,22,44a,380565,245,271970,272215,0.09000238781845232
J22,J,22,5a,375665,332,122303,122635,0.27072206140172056
J22,J,22,6a,359852,230,204366,204596,0.11241666503743963
J22,J,22,7a,464805,329,360796,361125,0.09110418830044999
J22,J,22,8a,309895,43,102778,102821,0.04182025072699157
J22,J,22,9a,410362,1606,415867,417473,0.38469553719641747
J22,J,22,T,456994,143,332223,332366,0.0430248581383174
J22,J,22,1b,493913,134,205485,205619,0.06516907484230544
J22,J,22,2b,483228,35,216269,216304,0.016180930542199868
J22,J,22,3b,586287,157,124952,125109,0.12549057222102328
J22,J,22,4b,533795,251,503182,503433,0.04985767718842427
J22,J,22,5b,754662,131,282435,282566,0.04636085020844687
J22,J,22,6b,498947,91,157562,157653,0.057721705264092656
J22,J,22,7b,531371,385,124844,125229,0.30743677582668555
J23,J,23,1,644758,100,506194,506294,0.01975136975749268
J23,J,23,10,375188,58,370434,370492,0.015654858944322683
J23,J,23,11,354470,71,212819,212890,0.03335055662548734
J23,J,23,12,551243,307,226139,226446,0.1355731609301997
J23,J,23,13,406695,700,257610,258310,0.2709922186520073
J23,J,23,14,702931,1042,550137,551179,0.18904929251658717
J23,J,23,15,362633,23,136616,136639,0.016832675883166594
J23,J,23,16,155506,18,106446,106464,0.016907123534715962
J23,J,23,17,520845,394,353129,353523,0.11144960865346809
J23,J,23,18,634779,35,338772,338807,0.010330365075101754
J23,J,23,19,358712,1302,169893,171195,0.7605362306142118
J23,J,23,2,372982,7,200437,200444,0.0034922472111911557
J23,J,23,20,711695,634,517471,518105,0.12236901786317446
J23,J,23,21,331438,18,280584,280602,0.006414779652318943
J23,J,23,22,419608,1,155317,155318,6.438403790932152e-4
J23,J,23,23,405387,514,380555,381069,0.13488370872466665
J23,J,23,24,291612,404,175408,175812,0.22979091302072668
J23,J,23,25,226516,71,194196,194267,0.03654763804454694
J23,J,23,26,544784,22,404586,404608,0.0054373615944321415
J23,J,23,27,322050,52,189463,189515,0.02743846133551434
J23,J,23,28,480394,772,403058,403830,0.19116955154396653
J23,J,23,29,459929,59561,84107,143668,41.45738786646992
J23,J,23,3,692394,67,645509,645576,0.010378328810240776
J23,J,23,30,371848,38486,89166,127652,30.14915551656065
J23,J,23,31,278278,47082,3500,50582,93.08054248546914
J23,J,23,32,480042,3,228819,228822,0.0013110627474630936
J23,J,23,33,393059,30,286447,286477,0.010472044876202976
J23,J,23,34,501454,38568,4158,42726,90.26822075551186
J23,J,23,35,480831,95779,88642,184421,51.93497486728735
J23,J,23,4,418210,27,172100,172127,0.015686092245841735
J23,J,23,5,427808,21,326731,326752,0.006426892566839682
J23,J,23,6,146640,31,65579,65610,0.0472488949855205
J23,J,23,7,747492,1527,627301,628828,0.2428326982895164
J23,J,23,8,845237,362,883873,884235,0.0409393430479454
J23,J,23,9,720472,254,322904,323158,0.07859932293181664
J23,J,23,T,471750,1083,408941,410024,0.26413088014360137
J24,J,24,1,178062,26,148972,148998,0.017449898656357803
J24,J,24,10,492709,726,299729,300455,0.24163352249088882
J24,J,24,11,210884,17,112499,112516,0.015108962280920048
J24,J,24,12,190133,37,109422,109459,0.03380261102330553
J24,J,24,13,397961,44,179571,179615,0.02449684046432648
J24,J,24,14,475805,118,194553,194671,0.060615089047675305
J24,J,24,15,344029,226,184576,184802,0.1222930487765284
J24,J,24,16,318242,99,126169,126268,0.07840466309753857
J24,J,24,17,344583,806,115328,116134,0.6940258666712591
J24,J,24,18,312817,6,130220,130226,0.004607374871377452
J24,J,24,19,274077,31,241290,241321,0.012845960359852644
J24,J,24,2,268642,9,122481,122490,0.0073475385745775165
J24,J,24,20,712447,1448,263167,264615,0.5472100976890955
J24,J,24,21,243385,43,96457,96500,0.04455958549222798
J24,J,24,22,396704,1097,175051,176148,0.6227717601108159
J24,J,24,23,633293,711,200970,201681,0.35253692712749346
J24,J,24,24,350725,643,261944,262587,0.24487122363254843
J24,J,24,25,504767,1122,109852,110974,1.0110476327788491
J24,J,24,26,475900,457,296713,297170,0.15378402934347343
J24,J,24,27,728775,468,390414,390882,0.11972922774648104
J24,J,24,28,436017,293,292434,292727,0.10009326095645431
J24,J,24,29,504940,1423,489057,490480,0.29012396020225084
J24,J,24,3,557281,313,321748,322061,0.09718655782600191
J24,J,24,30,314516,100,213996,214096,0.0467080188326732
J24,J,24,31,464334,11,175668,175679,0.006261419976206604
J24,J,24,32,428347,150,388253,388403,0.03861968110441989
J24,J,24,33,447318,18,166713,166731,0.010795832808535905
J24,J,24,34,432418,12,350058,350070,0.0034278858514011482
J24,J,24,35,273541,96,253169,253265,0.03790496120664127
J24,J,24,36,328049,516,271834,272350,0.18946208922342575
J24,J,24,37,855084,170,321706,321876,0.05281536989399645
J24,J,24,38,423173,53,137507,137560,0.038528642047106716
J24,J,24,39,440568,51,320781,320832,0.015896169958108917
J24,J,24,4,280703,10,132063,132073,0.007571570267957873
J24,J,24,40,286001,14,94365,94379,0.014833808368387035
J24,J,24,41,564788,97,354458,354555,0.02735823779103383
J24,J,24,42,254157,65,301366,301431,0.021563807305817913
J24,J,24,43,232194,12,81294,81306,0.014759058372075862
J24,J,24,5,263030,83,76954,77037,0.10774043641367136
J24,J,24,6,280938,127,189797,189924,0.06686885280427961
J24,J,24,7,207377,57,184416,184473,0.030898830723195266
J24,J,24,8,387503,593,358346,358939,0.165209130242186
J24,J,24,9,431311,551,279061,279612,0.19705878145430097
J24,J,24,T,498255,47,312738,312785,0.015026296018031557
J3,J,3,1,414170,118,220022,220140,0.05360225311165622
J3,J,3,10,245096,19,140805,140824,0.013492018405953531
J3,J,3,11,242112,51,143757,143808,0.035463951935914555
J3,J,3,12,418107,408,537701,538109,0.07582106970892513
J3,J,3,13,496488,6876,452852,459728,1.4956670030974837
J3,J,3,14,459678,28,221669,221697,0.01262985065201604
J3,J,3,15,314924,41,191447,191488,0.021411263368983954
J3,J,3,16,363445,53,142914,142967,0.03707149202263459
J3,J,3,17,362962,9,143441,143450,0.0062739630533286865
J3,J,3,18,418730,36,87646,87682,0.041057457630984694
J3,J,3,19,244462,0,113783,113783,0
J3,J,3,2,452490,60,181760,181820,0.032999670003299966
J3,J,3,20,203942,99,202265,202364,0.048921744974402555
J3,J,3,21,579206,1371,716550,717921,0.19096808701793094
J3,J,3,22,74871,34,57755,57789,0.0588347263320009
J3,J,3,23,164796,42035,10789,52824,79.57557170982886
J3,J,3,24,242704,410,327407,327817,0.1250697797856731
J3,J,3,25,380223,4,190294,190298,0.002101966389557431
J3,J,3,26,388012,68,182441,182509,0.03725843657025133
J3,J,3,27,510005,1563,559750,561313,0.2784542670488658
J3,J,3,28,482303,30,249775,249805,0.01200936730649907
J3,J,3,29,351555,32,102475,102507,0.031217380276468927
J3,J,3,3,496124,243,487458,487701,0.04982561036372695
J3,J,3,30,339119,6348,382243,388591,1.6335941902926212
J3,J,3,31,338666,938,322784,323722,0.28975478960342516
J3,J,3,32,306570,59,222775,222834,0.026477108520243767
J3,J,3,33,296091,877,232436,233313,0.37588989897691083
J3,J,3,34,505403,105,422721,422826,0.02483290999134396
J3,J,3,35,250336,4175,167634,171809,2.430024038321625
J3,J,3,36,387613,348,246847,247195,0.14077954651186309
J3,J,3,37,445799,163,528198,528361,0.030850119520555077
J3,J,3,38,198084,927,195405,196332,0.4721594034594463
J3,J,3,39,198740,54,195622,195676,0.027596639342586722
J3,J,3,4,251239,1466,133135,134601,1.0891449543465501
J3,J,3,40,366311,88,392958,393046,0.02238923688321469
J3,J,3,41,238734,379,161957,162336,0.23346639069584071
J3,J,3,42,294551,42,240088,240130,0.017490525965102234
J3,J,3,43,486980,392,431018,431410,0.09086483855265293
J3,J,3,5,277442,38,108360,108398,0.03505599734312441
J3,J,3,6,334165,66,267071,267137,0.024706424044591353
J3,J,3,7,265210,38,161130,161168,0.023577881465303284
J3,J,3,8,328464,40,381929,381969,0.010472054014854609
J3,J,3,9,378635,7,277070,277077,0.0025263735351544877
J3,J,3,T,365924,146,235232,235378,0.062027887058263724
J4,J,4,1,466748,13,268449,268462,0.004842398551750341
J4,J,4,10,335140,29,262935,262964,0.011028125522885261
J4,J,4,11,369875,49,228180,228229,0.02146966424074066
J4,J,4,12,355883,469,241752,242221,0.1936248302170332
J4,J,4,13,534703,634,421858,422492,0.15006201300853034
J4,J,4,14,529017,1701,591733,593434,0.2866367616280833
J4,J,4,15,713723,13,408715,408728,0.003180599322777006
J4,J,4,16,226314,33,236213,236246,0.013968490471796347
J4,J,4,17,395015,12,414006,414018,0.0028984247061721955
J4,J,4,18,442271,892,664293,665185,0.1340980328780715
J4,J,4,19,496631,370,473165,473535,0.07813572386412831
J4,J,4,2,253367,121,143140,143261,0.08446122810813829
J4,J,4,20,755069,17230,601437,618667,2.7850200511745413
J4,J,4,21,276708,17,317204,317221,0.00535903991223784
J4,J,4,22,526381,837,676168,677005,0.12363276489833899
J4,J,4,23,186414,10,103718,103728,0.009640598488354156
J4,J,4,24,297370,138,240842,240980,0.057266163167067806
J4,J,4,25,211929,34,122517,122551,0.027743551664205106
J4,J,4,26,257391,36,189801,189837,0.018963637225619875
J4,J,4,27,536110,28,250536,250564,0.011174789674494342
J4,J,4,28,321644,3,193783,193786,0.0015480994499086622
J4,J,4,29,609883,1939,586298,588237,0.3296290440757722
J4,J,4,3,306072,27,90529,90556,0.029815804585008175
J4,J,4,30,251439,26,153121,153147,0.016977152670310226
J4,J,4,31,534262,184,396042,396226,0.04643814388757931
J4,J,4,32,343953,463,228882,229345,0.20187926486297936
J4,J,4,33,707864,9538,667713,677251,1.408340482332252
J4,J,4,34,344014,19125,407751,426876,4.480223765215191
J4,J,4,35,217869,250,227913,228163,0.10957078930413783
J4,J,4,36,62959,31534,1477,33011,95.52573384629366
J4,J,4,37,112789,13962,175499,189461,7.369326668813107
J4,J,4,38,486779,2262,710619,712881,0.3173040100661962
J4,J,4,39,405563,389,436058,436447,0.0891288060176837
J4,J,4,4,374797,50,104814,104864,0.04768080561489167
J4,J,4,40,547907,260,464893,465153,0.05589558704340292
J4,J,4,5,288521,152,217547,217699,0.06982117510875108
J4,J,4,6,391411,675,352349,353024,0.1912051305293691
J4,J,4,7,359721,41,384673,384714,0.010657267476618996
J4,J,4,8,584151,591,507468,508059,0.11632507248173932
J4,J,4,T,356894,115,316635,316750,0.036306235201262825
J5,J,5,1,436563,15,228372,228387,0.006567799393135336
J5,J,5,10,233705,61,144282,144343,0.04226044906923093
J5,J,5,11,253245,67,149024,149091,0.04493899698841647
J5,J,5,12,369726,80,264257,264337,0.030264397341272696
J5,J,5,13,459971,179,183270,183449,0.09757480280622953
J5,J,5,14,258222,103,385095,385198,0.02673949501295438
J5,J,5,15,221521,13,123434,123447,0.01053083509522305
J5,J,5,16,192268,59,72177,72236,0.08167672628606235
J5,J,5,17,301645,510,203736,204246,0.24969889251197086
J5,J,5,18,192571,69,87783,87852,0.07854118289851113
J5,J,5,19,170655,1586,155317,156903,1.010815599446792
J5,J,5,2,320344,50,150166,150216,0.03328540235394366
J5,J,5,20,205419,12,122127,122139,0.009824871662613907
J5,J,5,21,238878,96,238386,238482,0.04025461041084862
J5,J,5,22,376080,125,358828,358953,0.03482350056971247
J5,J,5,23,397764,6,158740,158746,0.003779622793645194
J5,J,5,24,371641,28,184841,184869,0.015145860041434745
J5,J,5,25,173634,107,83979,84086,0.12725067193111814
J5,J,5,26,143471,12,114237,114249,0.01050337420896463
J5,J,5,27,77613,103,90750,90853,0.1133699492586926
J5,J,5,28,404722,237,401728,401965,0.058960357245033776
J5,J,5,29,555818,72,519940,520012,0.013845834326900149
J5,J,5,3,298238,521,272522,273043,0.19081243613643273
J5,J,5,30,266845,21,144244,144265,0.014556545246594808
J5,J,5,31,386424,64,300232,300296,0.021312305192210355
J5,J,5,32,339616,10,356546,356556,0.002804608532741
J5,J,5,33,358549,101,337522,337623,0.02991502356178341
J5,J,5,34,448227,76,247869,247945,0.030651959103833514
J5,J,5,35,499787,67,138735,138802,0.048270197835766054
J5,J,5,36,157355,294,140639,140933,0.2086097649237581
J5,J,5,37,160404,0,80964,80964,0
J5,J,5,38,411973,47,357756,357803,0.013135719935271644
J5,J,5,39,309866,123,231827,231950,0.05302866997197672
J5,J,5,4,438169,849,482546,483395,0.17563276409561537
J5,J,5,40,341211,266,328248,328514,0.08097067400476084
J5,J,5,41,300223,8,159796,159804,0.005006132512327601
J5,J,5,42,417043,72,409061,409133,0.01759818934185216
J5,J,5,43,254519,57,225079,225136,0.025318029990761142
J5,J,5,44,573268,323,566067,566390,0.05702784300570279
J5,J,5,5,302692,1,165091,165092,6.057228696726674e-4
J5,J,5,6,293014,366,317684,318050,0.11507624587329038
J5,J,5,7,356769,67,349414,349481,0.019171285420380508
J5,J,5,8,341333,63,200079,200142,0.0314776508678838
J5,J,5,9,332184,111,256975,257086,0.0431762134071867
J5,J,5,T,284648,58,254942,255000,0.022745098039215685
J6,J,6,1,183574,38,189243,189281,0.0200759717034462
J6,J,6,10,147142,117,229141,229258,0.05103420600371634
J6,J,6,11,266316,238,444550,444788,0.053508637822962855
J6,J,6,12,297769,139,164434,164573,0.08446099907032138
J6,J,6,13,329279,39,355177,355216,0.010979235169586956
J6,J,6,14,354516,82,269762,269844,0.030387927839788918
J6,J,6,15,414847,179,264804,264983,0.06755150330398554
J6,J,6,16,379076,23,300731,300754,0.0076474460855050965
J6,J,6,17,311971,51,242382,242433,0.021036740047765776
J6,J,6,18,233148,1008,226976,227984,0.44213629026598356
J6,J,6,19,580107,94,405434,405528,0.02317965713834803
J6,J,6,2,114365,60,116182,116242,0.05161645532595792
J6,J,6,20,253398,6,148480,148486,0.004040784989830691
J6,J,6,21,338508,54,63322,63376,0.08520575612219138
J6,J,6,22,252257,179,149448,149627,0.11963081529403116
J6,J,6,23,246052,118,155714,155832,0.0757225730273628
J6,J,6,24,280245,42,121597,121639,0.03452839960867814
J6,J,6,25,287653,24,114207,114231,0.021010058565538253
J6,J,6,26,182834,42,141742,141784,0.029622524403317724
J6,J,6,27,237182,29,87407,87436,0.03316711651951141
J6,J,6,28,239679,643,412246,412889,0.15573192795158022
J6,J,6,29,162276,86,202672,202758,0.042415095828524645
J6,J,6,3,173210,25,121645,121670,0.02054738226349963
J6,J,6,30,368916,223,438598,438821,0.05081798728866668
J6,J,6,31,388348,276,382600,382876,0.07208600173424294
J6,J,6,32,371394,316,399514,399830,0.07903358927544206
J6,J,6,33,422044,64,349116,349180,0.018328655707657942
J6,J,6,34,155626,146,165004,165150,0.08840448077505299
J6,J,6,35,269808,399,296073,296472,0.1345826924633692
J6,J,6,36,222755,1537,371108,372645,0.4124568959733794
J6,J,6,37,376709,836,217855,218691,0.38227453347417134
J6,J,6,38,722642,280,533166,533446,0.0524889117173997
J6,J,6,39,330730,86,133524,133610,0.06436643963775167
J6,J,6,4,234580,159,183004,183163,0.08680792518139581
J6,J,6,40,200448,98,278234,278332,0.03520974950778208
J6,J,6,41,665524,397,1129687,1130084,0.035130131919397144
J6,J,6,42,447423,43,466406,466449,0.009218585525963182
J6,J,6,43,287815,47,222546,222593,0.02111477000624458
J6,J,6,44,327072,20,141673,141693,0.014115023325076043
J6,J,6,45,370530,8,384517,384525,0.002080488914895
J6,J,6,5,191455,74,164916,164990,0.04485120310321838
J6,J,6,6,159733,31,82089,82120,0.0377496346809547
J6,J,6,7,527056,76,674893,674969,0.011259776374914996
J6,J,6,8,364754,151,444678,444829,0.033945628544901525
J6,J,6,9,361529,301,266406,266707,0.11285793023805149
J6,J,6,T,248570,76,265958,266034,0.028567777051053626
J7,J,7,1,359717,202,333239,333441,0.06058043252029594
J7,J,7,10,348273,60,340239,340299,0.017631553428014778
J7,J,7,11,139039,40,89890,89930,0.044479039252752144
J7,J,7,12,140692,604,115649,116253,0.5195564845638392
J7,J,7,13,278320,136,278493,278629,0.04881042533261075
J7,J,7,14,203434,33,159476,159509,0.02068848779692682
J7,J,7,15,278485,0,84458,84458,0
J7,J,7,16,239100,165,235858,236023,0.06990844112650038
J7,J,7,17,271960,112,183856,183968,0.06088015307009915
J7,J,7,18,388827,1620,366621,368241,0.43992928544078475
J7,J,7,19,328351,53,127876,127929,0.041429230276168814
J7,J,7,2,259375,339,277163,277502,0.12216128172049211
J7,J,7,20,246679,711,208890,209601,0.3392159388552536
J7,J,7,21,282907,218,173155,173373,0.1257404555495954
J7,J,7,22,364852,60,91368,91428,0.0656254101588135
J7,J,7,23,248831,181,332268,332449,0.05444444110224426
J7,J,7,24,204306,42,135132,135174,0.031071063962004524
J7,J,7,25,296824,201,254217,254418,0.07900384406763672
J7,J,7,26,367982,122,423456,423578,0.02880225129728173
J7,J,7,27,269670,246,219264,219510,0.1120677873445401
J7,J,7,28,277921,65,211194,211259,0.030767919946605826
J7,J,7,29,171960,21,177619,177640,0.011821661787885612
J7,J,7,3,147576,141,52883,53024,0.26591732045866023
J7,J,7,31,140666,76,140630,140706,0.05401333276477193
J7,J,7,32,308472,78,455916,455994,0.017105488230108292
J7,J,7,33,417403,108,346955,347063,0.031118269593704888
J7,J,7,34,259911,120,158524,158644,0.0756410579662641
J7,J,7,35,346652,606,215748,216354,0.28009650849995843
J7,J,7,36,540696,75,454649,454724,0.016493521344815756
J7,J,7,37,406654,128,364492,364620,0.03510504086446163
J7,J,7,38,324179,122,398093,398215,0.030636716346697134
J7,J,7,39,234374,9,151877,151886,0.0059254967541445555
J7,J,7,4,296022,505,314609,315114,0.160259461655147
J7,J,7,40,495309,137,485163,485300,0.028229960848959408
J7,J,7,41,732667,138,369747,369885,0.03730889330467578
J7,J,7,42,363176,711,235316,236027,0.30123672291729336
J7,J,7,5,233349,25,258002,258027,0.009688908525076834
J7,J,7,6,130107,17,41092,41109,0.04135347490817096
J7,J,7,7,275478,7,173891,173898,0.004025348192618661
J7,J,7,8,286902,403,366732,367135,0.10976888610456643
J7,J,7,9,237096,28,173426,173454,0.016142608414911157
J7,J,7,T,341773,26,271002,271028,0.009593104771462727
J8,J,8,1,478356,66,269442,269508,0.024489068970123335
J8,J,8,10,298894,56,184641,184697,0.030319929397878687
J8,J,8,11,235520,36,114508,114544,0.03142897052660986
J8,J,8,12,182101,78,167885,167963,0.046438799021213006
J8,J,8,13,455161,87,433730,433817,0.02005453912594481
J8,J,8,14,550633,47,338298,338345,0.013891146610708005
J8,J,8,15,425381,24,268435,268459,0.008939912612354214
J8,J,8,16,287449,13,156135,156148,0.008325434843866076
J8,J,8,17,282605,62,160930,160992,0.03851123037169549
J8,J,8,18,430016,178,323790,323968,0.054943698143026465
J8,J,8,19,408470,121,345393,345514,0.035020288613485995
J8,J,8,2,379863,24,164163,164187,0.014617478850335288
J8,J,8,20,220353,13,172422,172435,0.007539072694058631
J8,J,8,21,209525,28,183235,183263,0.015278588694935693
J8,J,8,22,468365,5998,355661,361659,1.658468336195145
J8,J,8,23,477550,133,490765,490898,0.027093204698328367
J8,J,8,24,248059,300,203321,203621,0.14733254428570727
J8,J,8,25,235660,137,215883,216020,0.06342005369873159
J8,J,8,26,218001,4635,82101,86736,5.3438018815716655
J8,J,8,27,476010,200,443410,443610,0.04508464642366042
J8,J,8,28,429713,181,328510,328691,0.055066916952396024
J8,J,8,29,356018,3,133089,133092,0.00225407988459111
J8,J,8,3,340605,157,351878,352035,0.04459783828312526
J8,J,8,30,332779,140,226781,226921,0.06169547992473151
J8,J,8,31,454116,92,486544,486636,0.018905300881973387
J8,J,8,32,362353,157,254788,254945,0.06158190982368747
J8,J,8,33,361737,378,276675,277053,0.13643598878192983
J8,J,8,34,369653,310,299934,300244,0.1032493571894859
J8,J,8,35,165653,40,56963,57003,0.07017174534673613
J8,J,8,36,285675,31,158707,158738,0.019529035265657874
J8,J,8,4,262818,82,190476,190558,0.04303151796303487
J8,J,8,5,242516,128,161222,161350,0.07933064766036567
J8,J,8,6,245020,394,213130,213524,0.18452258294149604
J8,J,8,7,421310,888,301705,302593,0.29346349717277004
J8,J,8,8,411492,231,240579,240810,0.095926248909929
J8,J,8,9,201720,150,185384,185534,0.08084771524356722
J8,J,8,T,497821,952,484132,485084,0.19625466929439028
J9,J,9,1,675376,630,299891,300521,0.209635932264301
J9,J,9,10,245630,32,146814,146846,0.021791536711929505
J9,J,9,11,199237,21,260742,260763,0.008053289768870583
J9,J,9,12,252771,328,206901,207229,0.1582790053515676
J9,J,9,13,349597,449,321072,321521,0.13964873212014145
J9,J,9,14,264838,54,218430,218484,0.024715768660405337
J9,J,9,15,182348,7,133881,133888,0.005228250478011473
J9,J,9,16,240219,0,76017,76017,0
J9,J,9,17,212069,18,202142,202160,0.00890383854372774
J9,J,9,18,241362,469,252618,253087,0.1853117702608194
J9,J,9,19,145309,48,76052,76100,0.06307490144546649
J9,J,9,2,281554,14,221272,221286,0.006326654194119827
J9,J,9,20,277913,79,360450,360529,0.02191224561685745
J9,J,9,21,375342,109,262991,263100,0.04142911440516914
J9,J,9,22,417069,115,431240,431355,0.026660175493503035
J9,J,9,23,171452,13,187410,187423,0.006936181791989244
J9,J,9,24,237206,23,256501,256524,0.00896602267234255
J9,J,9,25,296134,13,197583,197596,0.006579080548189235
J9,J,9,26,374057,46,119627,119673,0.03843807709341288
J9,J,9,27,299839,95,193796,193891,0.048996601183138984
J9,J,9,28,153955,40,108895,108935,0.036719144443934454
J9,J,9,29,223821,25,219444,219469,0.011391130410217387
J9,J,9,3,305525,12,265429,265441,0.0045207786287724955
J9,J,9,30,396101,136,357305,357441,0.038048237331475686
J9,J,9,31,267212,114,148947,149061,0.07647875701893855
J9,J,9,32,386831,270,347524,347794,0.07763216156690454
J9,J,9,33,438801,32,295792,295824,0.010817242684839634
J9,J,9,34,538718,246,660472,660718,0.03723222312696188
J9,J,9,35,181767,65,166999,167064,0.038907245127615765
J9,J,9,36,269590,110,335912,336022,0.03273595181267893
J9,J,9,37,265592,26,197802,197828,0.013142730048324808
J9,J,9,38,368016,56,95348,95404,0.058697748522074544
J9,J,9,39,270901,27,349484,349511,0.007725078752886175
J9,J,9,4,307135,231,281434,281665,0.08201231959952426
J9,J,9,40,388219,150,387040,387190,0.03874066995531909
J9,J,9,41,540061,30,434513,434543,0.006903804686762875
J9,J,9,42,257504,73,213036,213109,0.034254771032664035
J9,J,9,43,286518,13,268697,268710,0.004837929366231253
J9,J,9,44,306208,32,363245,363277,0.008808705202916782
J9,J,9,45,280072,77,215256,215333,0.035758569285710966
J9,J,9,5,617240,90,832030,832120,0.010815747728692978
J9,J,9,6,282793,12,175774,175786,0.0068264821999476635
J9,J,9,7,346118,46,112415,112461,0.0409030686193436
J9,J,9,8,487557,82,313681,313763,0.026134375308752147
J9,J,9,9,514255,111,424714,424825,0.026128405814158772
J9,J,9,T,377409,112,321170,321282,0.03486034075983093
L10,L,10,1,386875,550,493723,494273,0.1112745385647203
L10,L,10,10,577938,35,566667,566702,0.006176085491139964
L10,L,10,11,272060,41,149261,149302,0.02746111907409144
L10,L,10,12,391702,86,312084,312170,0.02754909184098408
L10,L,10,13,280249,39,196412,196451,0.01985227868527012
L10,L,10,14,247688,276,246061,246337,0.11204163402168575
L10,L,10,15,409385,380,325935,326315,0.11645189464168058
L10,L,10,16,470643,556,487841,488397,0.11384181311515018
L10,L,10,17,320472,51,144885,144936,0.0351879450240106
L10,L,10,18,395656,157,401125,401282,0.03912460563892724
L10,L,10,19,477558,126,466413,466539,0.027007388449840207
L10,L,10,2,335713,283,272125,272408,0.10388828521922999
L10,L,10,20,394515,137,203068,203205,0.06741960089564726
L10,L,10,21,281447,125,62928,63053,0.19824592009896436
L10,L,10,22,205805,31,57944,57975,0.05347132384648555
L10,L,10,23,217066,658,146702,147360,0.44652551574375676
L10,L,10,24,271491,86,181915,182001,0.04725248762369438
L10,L,10,25,206796,528,262476,263004,0.200757402929233
L10,L,10,26,395546,418,356286,356704,0.11718399569390868
L10,L,10,27,603331,737,636276,637013,0.1156962259796896
L10,L,10,28,461341,488,422945,423433,0.11524845725297746
L10,L,10,29,253969,64,207183,207247,0.030881026022089586
L10,L,10,3,248399,3609,133012,136621,2.6416143931020852
L10,L,10,30,212245,40,99125,99165,0.0403368123834014
L10,L,10,31,193719,2303,161530,163833,1.405699706408355
L10,L,10,32,431168,1727,566334,568061,0.30401664609962664
L10,L,10,33,316870,342,245528,245870,0.13909789726278113
L10,L,10,34,198472,640,88552,89192,0.7175531437797111
L10,L,10,35,276489,48,120183,120231,0.039923147940215085
L10,L,10,36,343937,29,218750,218779,0.013255385571741347
L10,L,10,37,335424,848,249628,250476,0.3385553905364187
L10,L,10,38,336625,116,338529,338645,0.03425415996102113
L10,L,10,39,250367,3067,218971,222038,1.3812950936326214
L10,L,10,4,80122,11,40935,40946,0.02686465100376105
L10,L,10,40,311904,186,318046,318232,0.058447924784433995
L10,L,10,41,511782,241,563260,563501,0.042768335814843274
L10,L,10,42,557060,378,517845,518223,0.07294157148563456
L10,L,10,43,439386,339,281776,282115,0.12016376300444853
L10,L,10,44,234647,512,159917,160429,0.31914429436074526
L10,L,10,45,211901,564,182611,183175,0.3079022792411628
L10,L,10,46,165558,35,47995,48030,0.07287112221528211
L10,L,10,47,221401,112,143819,143931,0.07781506416268906
L10,L,10,48,353990,3555,329141,332696,1.0685430543198597
L10,L,10,49,262362,377,149375,149752,0.2517495592713286
L10,L,10,5,459745,412,517283,517695,0.07958353857000744
L10,L,10,50,195163,309,81444,81753,0.3779677809988624
L10,L,10,51,374204,315,378561,378876,0.08314065815728629
L10,L,10,52,570031,703,579602,580305,0.12114319194216833
L10,L,10,53,572632,779,500989,501768,0.15525103234961177
L10,L,10,54,385420,1100,279354,280454,0.39222118422272456
L10,L,10,55,393414,76,201182,201258,0.0377624740382991
L10,L,10,56,546394,118,344043,344161,0.034286278805559026
L10,L,10,57,147442,38,52504,52542,0.07232309390582771
L10,L,10,58,232317,322,131742,132064,0.24382117761085534
L10,L,10,59,230440,1496,261403,262899,0.56903982137627
L10,L,10,6,367910,819,465751,466570,0.1755363611033714
L10,L,10,60,378361,777,453278,454055,0.17112464349032605
L10,L,10,61,470332,4067,559944,564011,0.7210852270611743
L10,L,10,62,196705,13,86264,86277,0.01506774690821424
L10,L,10,7,288111,7923,100718,108641,7.292826833331799
L10,L,10,8,304143,26,92583,92609,0.0280750251055513
L10,L,10,9,545177,2023,597440,599463,0.3374687011541997
L11,L,11,1a,392687,182,185182,185364,0.09818519237823958
L11,L,11,10a,533053,413,570504,570917,0.07233976217208456
L11,L,11,11a,299499,529,254462,254991,0.20745830244989039
L11,L,11,12a,373528,220,333508,333728,0.06592194841307891
L11,L,11,13a,609986,1084,413556,414640,0.2614316033185414
L11,L,11,14a,301221,792,127122,127914,0.6191660021576997
L11,L,11,16a,180340,274,71044,71318,0.38419473344737654
L11,L,11,17a,172175,0,96753,96753,0
L11,L,11,18a,895590,957,642444,643401,0.14874083192285992
L11,L,11,19a,407930,69,221256,221325,0.031175872585564215
L11,L,11,2a,449710,170,558440,558610,0.030432681119206606
L11,L,11,20a,417189,66,237059,237125,0.027833421191354773
L11,L,11,21a,236843,24,87691,87715,0.02736134070569458
L11,L,11,23a,291241,1620,98775,100395,1.6136261766024205
L11,L,11,24a,344414,1672,214080,215752,0.7749638473803255
L11,L,11,25a,746377,727,616999,617726,0.1176897200376866
L11,L,11,26a,300030,452,409518,409970,0.11025196965631633
L11,L,11,27a,564310,204,531154,531358,0.03839219509257412
L11,L,11,28a,254921,130,162145,162275,0.08011092281620706
L11,L,11,29a,166991,121,152110,152231,0.07948446768398026
L11,L,11,3a,745468,687,683441,684128,0.1004198044810328
L11,L,11,30a,519254,528,269810,270338,0.19531105504960458
L11,L,11,31a,344064,259,223967,224226,0.11550846021424813
L11,L,11,32a,283240,776,119904,120680,0.6430228704010607
L11,L,11,33a,719669,1026,790344,791370,0.12964858410098942
L11,L,11,34a,553234,1185,591671,592856,0.1998799033829463
L11,L,11,35a,449587,3220,563563,566783,0.5681186626980697
L11,L,11,36a,295964,673,206283,206956,0.3251898954367112
L11,L,11,37a,375800,32,486116,486148,0.006582357635946255
L11,L,11,38a,235895,8,59547,59555,0.013432961128368736
L11,L,11,39a,652492,459,593657,594116,0.07725763992217008
L11,L,11,4a,318784,3951,143000,146951,2.688651319147199
L11,L,11,40a,342172,1865,282267,284132,0.6563850604648543
L11,L,11,41a,628811,15164,590387,605551,2.5041656276680246
L11,L,11,42a,337751,591,249658,250249,0.23616477987924026
L11,L,11,43a,334612,40,171616,171656,0.023302418791070513
L11,L,11,44a,372738,49,133481,133530,0.03669587358645997
L11,L,11,45a,224660,56,91304,91360,0.06129597197898424
L11,L,11,46a,398594,55,283007,283062,0.019430372144618492
L11,L,11,47a,422155,649,637936,638585,0.10163094967780327
L11,L,11,48a,140467,14,48895,48909,0.02862458852154
L11,L,11,49a,342934,46,313340,313386,0.014678383846119481
L11,L,11,5a,423465,4650,339705,344355,1.3503506555734635
L11,L,11,50a,212320,311,102549,102860,0.3023527124246549
L11,L,11,51a,227134,281,116500,116781,0.24062133394987198
L11,L,11,52a,198785,368,96527,96895,0.37979255895557046
L11,L,11,53a,453478,1869,384663,386532,0.4835304709571264
L11,L,11,54a,252840,4,217368,217372,0.0018401634065104981
L11,L,11,55a,431689,882,395191,396073,0.22268622198433116
L11,L,11,56a,265949,15,126836,126851,0.011824896926315125
L11,L,11,6a,319007,635,150053,150688,0.42140050966234865
L11,L,11,7a,381261,460,226784,227244,0.20242558659414547
L11,L,11,8a,666519,551,623247,623798,0.08832987601755697
L11,L,11,9a,755180,3927,457333,461260,0.8513636560724971
L12,L,12,1b,262409,2184,148435,150619,1.4500162662081146
L12,L,12,10b,458111,407,364154,364561,0.11164112453059982
L12,L,12,11b,324441,521,171958,172479,0.3020657587300483
L12,L,12,12b,298673,1341,278278,279619,0.47958114434283794
L12,L,12,13b,434100,96,380670,380766,0.02521233513496478
L12,L,12,2b,373839,4868,333129,337997,1.4402494696698491
L12,L,12,3b,256535,67,103758,103825,0.06453166385745245
L12,L,12,4b,283488,136,140240,140376,0.09688265800421725
L12,L,12,5b,333624,164,90076,90240,0.18173758865248227
L12,L,12,6b,372904,410,147140,147550,0.277871907827855
L12,L,12,7b,453543,306,396576,396882,0.07710100231303006
L12,L,12,8b,431271,62,235199,235261,0.026353709284581806
L12,L,12,9b,479927,217,249126,249343,0.08702871145370032
L13,L,13,1a,172733,22,130913,130935,0.016802230114178793
L13,L,13,10a,300972,89,236298,236387,0.03765012458383921
L13,L,13,11a,327417,91,363938,364029,0.024998008400429636
L13,L,13,12a,260486,158,118820,118978,0.1327976600716099
L13,L,13,13a,556805,79,541010,541089,0.014600185921354899
L13,L,13,14a,396036,211,328361,328572,0.0642172796221224
L13,L,13,15a,415799,41,308768,308809,0.013276815118730346
L13,L,13,16a,324056,32,185512,185544,0.017246583020739014
L13,L,13,17a,308129,153,256758,256911,0.059553697583988235
L13,L,13,18a,234965,43,98692,98735,0.043550919126955995
L13,L,13,19a,330677,26,362927,362953,0.007163461935842933
L13,L,13,2a,384163,182,504235,504417,0.03608125816536715
L13,L,13,20a,265510,111,318391,318502,0.034850644579939846
L13,L,13,21a,347961,21,312006,312027,0.006730186810756761
L13,L,13,22a,304592,88,179353,179441,0.04904118902591938
L13,L,13,23a,226466,27,64171,64198,0.04205738496526371
L13,L,13,24a,264134,141,231924,232065,0.060758839118350456
L13,L,13,25a,278105,22,198711,198733,0.011070129268918599
L13,L,13,26a,386899,78,676106,676184,0.01153532174674349
L13,L,13,27a,468066,33,390971,391004,0.008439811357428568
L13,L,13,28a,430120,46,267930,267976,0.017165716332805923
L13,L,13,29a,274564,69,150071,150140,0.04595710670041295
L13,L,13,3a,248437,25,95058,95083,0.026292817853875036
L13,L,13,30a,353547,0,71157,71157,0
L13,L,13,31a,333307,869,272828,273697,0.31750439354468624
L13,L,13,32a,449835,338,427599,427937,0.07898358870581416
L13,L,13,33a,276069,471,103120,103591,0.45467270322711434
L13,L,13,34a,368597,1488,496501,497989,0.2988017807622257
L13,L,13,35a,442614,750,574731,575481,0.13032576227538353
L13,L,13,36a,338060,313,283003,283316,0.11047734684945432
L13,L,13,37a,482658,548,353344,353892,0.15484950210798773
L13,L,13,38a,346902,254,398512,398766,0.06369650371395756
L13,L,13,39a,214368,1090,85298,86388,1.2617493170347733
L13,L,13,4a,311693,64,283968,284032,0.02253267237494367
L13,L,13,40a,226826,98,73832,73930,0.1325578249695658
L13,L,13,41a,470875,121,488439,488560,0.02476666120844932
L13,L,13,42a,336365,1128,361633,362761,0.3109485308508908
L13,L,13,43a,189331,97,82525,82622,0.11740214470722084
L13,L,13,44a,300967,10,154500,154510,0.006472073004983496
L13,L,13,45a,597019,495,502626,503121,0.09838587536596564
L13,L,13,46a,313986,1560,298710,300270,0.5195324208212609
L13,L,13,47a,294252,0,217961,217961,0
L13,L,13,48a,229174,0,97426,97426,0
L13,L,13,49a,229449,51,115468,115519,0.0441485816186082
L13,L,13,5a,356536,128,338641,338769,0.037783858617524035
L13,L,13,50a,462700,274,430840,431114,0.06355627513836247
L13,L,13,51a,300504,74,192787,192861,0.0383696029783108
L13,L,13,52a,482990,324,386786,387110,0.08369714034770478
L13,L,13,53a,138335,137,107158,107295,0.12768535346474671
L13,L,13,54a,174032,1,176915,176916,5.652400009043839e-4
L13,L,13,55a,648476,173,677351,677524,0.025534150819749562
L13,L,13,56a,185137,510,212171,212681,0.23979575044315196
L13,L,13,57a,556213,107,648577,648684,0.016494934359410747
L13,L,13,58a,328938,123,281320,281443,0.04370334312809343
L13,L,13,59a,260165,496,203272,203768,0.24341407875623255
L13,L,13,6a,189776,0,97201,97201,0
L13,L,13,60a,352930,49,123349,123398,0.03970890938264802
L13,L,13,61a,626795,173,533808,533981,0.03239815648871402
L13,L,13,62a,352252,153,288019,288172,0.053093291506461415
L13,L,13,63a,369619,120,199886,200006,0.059998200053998384
L13,L,13,64a,536135,122,449109,449231,0.027157520295794366
L13,L,13,65a,303125,6,307144,307150,0.0019534429431873677
L13,L,13,66a,139468,76,92413,92489,0.08217193395971413
L13,L,13,7a,304585,268,363347,363615,0.0737043301293951
L13,L,13,8a,136482,39,63121,63160,0.06174794173527549
L13,L,13,9a,462661,409,441106,441515,0.09263558429498432
L13,L,13,1b,486828,242,225402,225644,0.10724858626863555
L13,L,13,10b,326498,97,93573,93670,0.1035550336286965
L13,L,13,11b,675072,68,667068,667136,0.010192824251726785
L13,L,13,2b,403503,27,175438,175465,0.015387684153534892
L13,L,13,3b,225697,9,48204,48213,0.018667164457718873
L13,L,13,4b,285614,420,172990,173410,0.242200565134652
L13,L,13,5b,293438,12,210926,210938,0.00568887540414719
L13,L,13,6b,456107,1497,291101,292598,0.5116234560728372
L13,L,13,7b,584088,103,407609,407712,0.025262930696177695
L13,L,13,8b,722076,264,435105,435369,0.060638217236413244
L13,L,13,9b,315695,2,104471,104473,0.001914370220056857
L13,L,13,T,317177,626,303674,304300,0.20571804140650674
L14,L,14,1,216130,3672,69032,72704,5.050616197183098
L14,L,14,10,348420,49,231863,231912,0.021128703991169066
L14,L,14,11,164380,39,100234,100273,0.03889381987175013
L14,L,14,12,118286,62,60704,60766,0.10203074087483133
L14,L,14,13,152536,33,74126,74159,0.044498981917231895
L14,L,14,14,151621,227,156224,156451,0.14509335191210027
L14,L,14,15,214708,183,182993,183176,0.09990391754378303
L14,L,14,16,92312,26,44414,44440,0.0585058505850585
L14,L,14,17,198669,87,121381,121468,0.07162380215365363
L14,L,14,18,331572,443,357955,358398,0.12360560047768124
L14,L,14,19,393752,242,327350,327592,0.07387237783584459
L14,L,14,2,192915,1339,86169,87508,1.5301458152397494
L14,L,14,20,299373,284,410273,410557,0.06917431684272829
L14,L,14,21,266882,477,166711,167188,0.28530755795870516
L14,L,14,22,272107,154,161809,161963,0.09508344498434827
L14,L,14,23,301994,298,212084,212382,0.14031320921735366
L14,L,14,24,240076,494,99054,99548,0.496243018443364
L14,L,14,25,417932,351,325416,325767,0.10774572010056266
L14,L,14,26,293739,458,340555,341013,0.13430573028007728
L14,L,14,27,156002,124,65570,65694,0.1887539196882516
L14,L,14,28,403618,205,382711,382916,0.053536545874290964
L14,L,14,29,332804,540,199606,200146,0.269803043778042
L14,L,14,3,264679,4982,144480,149462,3.3332887289076822
L14,L,14,30,183836,524,154220,154744,0.3386237915524996
L14,L,14,31,289259,164,312806,312970,0.05240118861232706
L14,L,14,32,462566,3655,400163,403818,0.9051107181948302
L14,L,14,33,246060,78,173393,173471,0.04496428797897055
L14,L,14,34,278560,350,245860,246210,0.14215507087445678
L14,L,14,35,272933,241,291026,291267,0.08274195154274257
L14,L,14,36,143503,145,116027,116172,0.12481492958716386
L14,L,14,37,206279,69,53327,53396,0.1292231627837291
L14,L,14,38,166890,7,52143,52150,0.013422818791946307
L14,L,14,39,151668,3,84389,84392,0.0035548393212626794
L14,L,14,4,427532,560,365918,366478,0.1528058983076747
L14,L,14,40,217168,100,156716,156816,0.06376900316294255
L14,L,14,41,161181,607,100964,101571,0.5976115229740773
L14,L,14,42,220980,625,185120,185745,0.33648281245793965
L14,L,14,43,216160,113,214402,214515,0.052676968976528446
L14,L,14,44,391751,544,330377,330921,0.16438968817331026
L14,L,14,45,445086,574,355560,356134,0.1611752879534108
L14,L,14,46,414775,490,508915,509405,0.09619065380198466
L14,L,14,47,543755,597,562592,563189,0.10600349083522582
L14,L,14,48,539829,1332,564159,565491,0.2355475153450718
L14,L,14,49,342375,136,343085,343221,0.039624615043951275
L14,L,14,5,204156,1247,201989,203236,0.6135723985908008
L14,L,14,50,171809,26,132548,132574,0.019611688566385566
L14,L,14,6,435913,264,369272,369536,0.07144094215448563
L14,L,14,7,182817,87,80506,80593,0.10794982194483392
L14,L,14,8,182817,32,128635,128667,0.024870401890150544
L14,L,14,9,240885,10303,152844,163147,6.315163625442086
L15,L,15,1a,615883,269,515470,515739,0.05215816527352013
L15,L,15,10a,226341,36,236680,236716,0.015208097467006876
L15,L,15,11a,287347,198,287315,287513,0.06886645125611711
L15,L,15,12a,184252,6,181537,181543,0.003305002120709694
L15,L,15,13a,303882,3,136369,136372,0.00219986507494207
L15,L,15,14a,282873,604,253015,253619,0.23815250434707178
L15,L,15,15a,181855,9,43244,43253,0.02080780523894296
L15,L,15,16a,501066,158,383224,383382,0.04121215915196853
L15,L,15,17a,598739,2283,475768,478051,0.4775641092686763
L15,L,15,18a,451757,460,574163,574623,0.08005248658685782
L15,L,15,19a,404560,377,569855,570232,0.06611344154659858
L15,L,15,2a,561963,674,595267,595941,0.11309844430908429
L15,L,15,20a,176062,42,217016,217058,0.019349666909305344
L15,L,15,21a,316911,72,76137,76209,0.09447703027201512
L15,L,15,22a,192726,2,143260,143262,0.0013960436124024515
L15,L,15,23a,334564,1737,356487,358224,0.48489213453034974
L15,L,15,24a,280666,126,316342,316468,0.03981445201410569
L15,L,15,25a,337174,320,411990,412310,0.07761150590575053
L15,L,15,26a,202506,945,136549,137494,0.6873027186640871
L15,L,15,27a,276524,619,371631,372250,0.16628609805238415
L15,L,15,28a,120260,36,104157,104193,0.03455126544009674
L15,L,15,29a,498711,158,531631,531789,0.02971103200705543
L15,L,15,3a,246782,244,214750,214994,0.11349153929877112
L15,L,15,30a,129877,31,45913,45944,0.06747344593418074
L15,L,15,31a,192377,194,197995,198189,0.09788636099884454
L15,L,15,32a,252487,21,250496,250517,0.008382664649504825
L15,L,15,33a,347155,79,155770,155849,0.05069009104966988
L15,L,15,34a,320624,173,365545,365718,0.04730420706664698
L15,L,15,35a,252312,292,368715,369007,0.07913129019232698
L15,L,15,36a,433822,524,490170,490694,0.10678752949903605
L15,L,15,37a,111412,27,41831,41858,0.06450379855702613
L15,L,15,38a,370590,860,437204,438064,0.19631834617772748
L15,L,15,39a,323267,2727,261215,263942,1.03318153230634
L15,L,15,4a,301017,24,266166,266190,0.009016116307900371
L15,L,15,40a,207543,62,73260,73322,0.08455852268077794
L15,L,15,41a,222273,45,215959,216004,0.020832947538008555
L15,L,15,42a,188559,1397,157116,158513,0.8813157280475419
L15,L,15,43a,336456,350,417754,418104,0.0837112297418824
L15,L,15,44a,268670,472,318378,318850,0.14803198996393288
L15,L,15,45a,331717,17,212640,212657,0.007994093775422394
L15,L,15,46a,284843,63,149254,149317,0.04219211476255215
L15,L,15,47a,391451,155,459410,459565,0.033727546701772325
L15,L,15,48a,181211,39,84935,84974,0.045896391837503235
L15,L,15,49a,269044,365,247349,247714,0.14734734411458375
L15,L,15,5a,313722,3076,292564,295640,1.040454606954404
L15,L,15,50a,125560,17,56187,56204,0.030246957511920858
L15,L,15,51a,239069,187,177417,177604,0.1052904213869057
L15,L,15,52a,309940,652,248182,248834,0.2620220709388588
L15,L,15,53a,167423,1044,110533,111577,0.9356767075651793
L15,L,15,54a,371204,315,279235,279550,0.1126810946163477
L15,L,15,55a,497023,680,219110,219790,0.30938623231266205
L15,L,15,56a,589527,431,552322,552753,0.07797334433282135
L15,L,15,57a,516981,956,622363,623319,0.1533725107047916
L15,L,15,58a,320883,260,191170,191430,0.13581988194117955
L15,L,15,59a,238878,15,157907,157922,0.00949835994984866
L15,L,15,6a,293221,125,187029,187154,0.06678991632559284
L15,L,15,7a,432082,762,493529,494291,0.15416020117703944
L15,L,15,8a,701510,705,457276,457981,0.1539365170170815
L15,L,15,9a,334692,807,100499,101306,0.7965964503583204
L15,L,15,T,296890,334,198726,199060,0.16778860645031649
L15,L,15,1b,274771,591,164200,164791,0.35863609056319823
L15,L,15,10b,284191,297,254717,255014,0.11646419412267561
L15,L,15,11b,216428,92,118122,118214,0.07782496151048099
L15,L,15,12b,186861,70,46567,46637,0.15009541780131655
L15,L,15,13b,374494,352,327618,327970,0.10732688965454157
L15,L,15,14b,311106,1821,139693,141514,1.2867984793024012
L15,L,15,15b,440366,636,378178,378814,0.16789242213856934
L15,L,15,16b,291037,128,271807,271935,0.04707007189218012
L15,L,15,17b,557599,589,471384,471973,0.12479527430594547
L15,L,15,18b,435119,163,390366,390529,0.04173825759418635
L15,L,15,19b,211624,6,103136,103142,0.005817222857807683
L15,L,15,2b,369420,344,260929,261273,0.13166304976021248
L15,L,15,20b,484544,381,373009,373390,0.10203808350518226
L15,L,15,21b,334174,1582,395094,396676,0.3988141455495165
L15,L,15,22b,174656,31,134833,134864,0.022986119349863568
L15,L,15,23b,485729,883,447240,448123,0.19704411512017905
L15,L,15,24b,299316,82,238286,238368,0.03440059068331319
L15,L,15,25b,536426,319,398343,398662,0.08001765906958777
L15,L,15,3b,217629,424,233769,234193,0.18104725589577828
L15,L,15,4b,300362,96,198022,198118,0.04845597068413774
L15,L,15,5b,245582,47,252851,252898,0.018584567691322194
L15,L,15,6b,201198,2,110127,110129,0.0018160520843737797
L15,L,15,7b,523975,1306,343601,344907,0.37865279626102105
L15,L,15,8b,147148,35,105437,105472,0.033184162621359224
L15,L,15,9b,191685,274,216487,216761,0.12640650301484124
L16,L,16,1,349634,51,266275,266326,0.019149463439544018
L16,L,16,10,169592,15,131425,131440,0.011412051125989045
L16,L,16,11,279894,177,247734,247911,0.07139658990524825
L16,L,16,12,350768,171,420005,420176,0.040697231636266706
L16,L,16,13,396818,79,424133,424212,0.018622764089653285
L16,L,16,14,483966,374,643714,644088,0.058066599595086386
L16,L,16,15,654092,746,703860,704606,0.10587477256793157
L16,L,16,16,113835,59,41578,41637,0.1417008910344165
L16,L,16,17,155531,286,151033,151319,0.18900468546580404
L16,L,16,18,166884,98,150388,150486,0.06512233696157782
L16,L,16,19,122451,69,76525,76594,0.09008538527822023
L16,L,16,2,285216,178,391832,392010,0.04540700492334379
L16,L,16,20,328798,137,418105,418242,0.03275615552718283
L16,L,16,21,198369,414,88153,88567,0.4674427269750584
L16,L,16,22,292523,24,212503,212527,0.011292682812066232
L16,L,16,23,216420,1231,234733,235964,0.521689749283789
L16,L,16,24,206984,14,179211,179225,0.007811410238526992
L16,L,16,25,282202,314,318176,318490,0.09859022261295487
L16,L,16,26,217270,123,210287,210410,0.058457297656955474
L16,L,16,27,134927,18,114885,114903,0.015665387326701655
L16,L,16,28,340016,104,340976,341080,0.030491380321332237
L16,L,16,29,261477,1463,159320,160783,0.9099220688754408
L16,L,16,3,247729,21,167960,167981,0.012501413850375936
L16,L,16,30,384757,132,434321,434453,0.030383033377603563
L16,L,16,31,202244,66,72182,72248,0.09135200974421437
L16,L,16,32,158754,194,61748,61942,0.31319621581479445
L16,L,16,33,356888,95,373833,373928,0.025405960505765816
L16,L,16,34,381480,176,388834,389010,0.04524305287781805
L16,L,16,35,219155,64,223041,223105,0.028686044687478988
L16,L,16,36,249850,336,192074,192410,0.1746270983836599
L16,L,16,37,294681,930,320455,321385,0.2893725593913842
L16,L,16,38,280137,334,241689,242023,0.13800341289877407
L16,L,16,39,415694,67,328927,328994,0.020365113041575227
L16,L,16,4,167875,3,82416,82419,0.003639937393076839
L16,L,16,40,125436,9,98163,98172,0.009167583425009167
L16,L,16,41,314326,74,347160,347234,0.021311277121480038
L16,L,16,42,154785,33,98806,98839,0.03338763038881413
L16,L,16,43,241036,371,353253,353624,0.10491369364070312
L16,L,16,44,217329,278,271609,271887,0.10224836053213282
L16,L,16,45,168953,153,133490,133643,0.1144841106530084
L16,L,16,46,392449,443,466708,467151,0.0948301512787086
L16,L,16,47,244781,1086,348662,349748,0.3105092809680113
L16,L,16,48,250344,494,295526,296020,0.1668806161745828
L16,L,16,49,328734,28,176138,176166,0.015894099883064835
L16,L,16,5,426636,132,410502,410634,0.032145414164438404
L16,L,16,50,591253,193,747304,747497,0.0258195016167289
L16,L,16,51,217546,28,175711,175739,0.01593271840627294
L16,L,16,52,204544,348,196308,196656,0.1769587503051013
L16,L,16,53,262164,2,288504,288506,6.932264840245956e-4
L16,L,16,54,451311,270,570528,570798,0.04730219797546593
L16,L,16,55,280616,69,206310,206379,0.033433634236041454
L16,L,16,56,418549,1521,566554,568075,0.2677463363112265
L16,L,16,57,197822,0,161152,161152,0
L16,L,16,58,147560,251,82079,82330,0.30487064253613505
L16,L,16,59,149348,5,151009,151014,0.0033109513025282424
L16,L,16,6,455397,154,351164,351318,0.04383493017721836
L16,L,16,60,457839,400,543619,544019,0.07352684373156085
L16,L,16,61,208481,221,236778,236999,0.09324933860480425
L16,L,16,62,498654,122,603424,603546,0.020213869365383916
L16,L,16,63,359031,850,435591,436441,0.19475713784910217
L16,L,16,64,352637,922,441913,442835,0.20820395858502602
L16,L,16,65,512308,386,608538,608924,0.06339050521904212
L16,L,16,66,404231,603,452158,452761,0.13318284922950518
L16,L,16,67,486828,1169,404449,405618,0.2882022000996011
L16,L,16,7,492233,311,543305,543616,0.05720950082411114
L16,L,16,8,507333,2053,540243,542296,0.3785755380825232
L16,L,16,9,287237,85,293928,294013,0.028910286279858373
L16,L,16,T,548647,215,457698,457913,0.04695215029929266
L17,L,17,1,625040,70,404754,404824,0.017291464932909114
L17,L,17,10,520094,995,480791,481786,0.20652322815523905
L17,L,17,11,200474,432,125792,126224,0.34224870072252506
L17,L,17,12,535580,325,661995,662320,0.04906993598260659
L17,L,17,13,448726,4415,364767,369182,1.195887123424219
L17,L,17,14,552580,61,265267,265328,0.02299041186757523
L17,L,17,15,490338,2963,448694,451657,0.656028800616397
L17,L,17,16,213280,16,68136,68152,0.023476933912431035
L17,L,17,17,519474,14307,337929,352236,4.061765407283753
L17,L,17,18,418704,472,452534,453006,0.10419288044749958
L17,L,17,19,396262,7,212339,212346,0.0032965066448155367
L17,L,17,2,562424,684,563392,564076,0.12126025571022345
L17,L,17,20,273270,356,109882,110238,0.3229376440066039
L17,L,17,21,523039,3570,491543,495113,0.7210475184452841
L17,L,17,22,389939,63,249328,249391,0.02526153710438628
L17,L,17,23,542477,1285,244506,245791,0.5228018926649064
L17,L,17,24,943754,1994,692708,694702,0.28702954648180085
L17,L,17,25,356994,14,79992,80006,0.017498687598430117
L17,L,17,26,325393,283,172979,173262,0.16333645000057717
L17,L,17,27,210205,2932,112681,115613,2.5360469843356714
L17,L,17,28,203005,169,122644,122813,0.13760758225920708
L17,L,17,29,200729,78,125011,125089,0.06235560281079871
L17,L,17,3,254303,46,141795,141841,0.03243067942273391
L17,L,17,30,243532,58,82228,82286,0.07048586636851956
L17,L,17,31,586203,2225,659240,661465,0.33637456252409426
L17,L,17,32,352422,506,362496,363002,0.13939317138748547
L17,L,17,33,468375,750,544170,544920,0.13763488218454084
L17,L,17,34,335053,1874,235717,237591,0.7887504156302216
L17,L,17,35,318887,198,199315,199513,0.09924165342609254
L17,L,17,36,444760,1107,482525,483632,0.2288930426439938
L17,L,17,4,394294,1693,288835,290528,0.5827321290891068
L17,L,17,5,507221,137,486786,486923,0.028135865424307335
L17,L,17,6,525002,7075,557251,564326,1.2537079631276957
L17,L,17,7,279326,3,110475,110478,0.002715472763808179
L17,L,17,9,468950,337,316113,316450,0.10649391689050404
L17,L,17,T,465420,1095,285857,286952,0.3815969221333185
L19,L,19,1,539563,6334,398082,404416,1.5662090520652001
L19,L,19,10,537122,447,789930,790377,0.05655528943782524
L19,L,19,11,406296,228,366738,366966,0.062131096613855234
L19,L,19,12,469593,961,214226,215187,0.44658831620869294
L19,L,19,13,554696,479,382554,383033,0.12505449922069378
L19,L,19,16,384672,165,325673,325838,0.05063866092966443
L19,L,19,17,307749,28,127253,127281,0.02199857009294396
L19,L,19,18,407692,276,375370,375646,0.07347342977164671
L19,L,19,19,125219,11,37515,37526,0.029313009646644992
L19,L,19,2,281554,58,120814,120872,0.04798464491362764
L19,L,19,20,151783,492,178165,178657,0.2753880340540813
L19,L,19,21,158990,40,217156,217196,0.01841654542440929
L19,L,19,22,483469,738,470043,470781,0.15676078686268136
L19,L,19,23,385321,1321,435436,436757,0.30245651472100044
L19,L,19,24,237257,29,171926,171955,0.01686487743886482
L19,L,19,25,227318,87,201151,201238,0.043232391496635825
L19,L,19,26,304065,31,124460,124491,0.0249013984946703
L19,L,19,27,171528,113,144016,144129,0.07840198710877061
L19,L,19,28,425816,298,492555,492853,0.060464276366381055
L19,L,19,29,173807,335,145716,146051,0.2293719317224805
L19,L,19,3,135530,76,70458,70534,0.10774945416394931
L19,L,19,30,470643,315,346482,346797,0.09083123556432149
L19,L,19,31,290898,4,122741,122745,0.003258788545358263
L19,L,19,32,321165,362,229307,229669,0.15761813740644146
L19,L,19,33,220064,31,96615,96646,0.032075823107009085
L19,L,19,34,262977,18,145067,145085,0.012406520315677017
L19,L,19,35,315784,100,320290,320390,0.03121196042323418
L19,L,19,36,141469,25,74839,74864,0.03339388758281684
L19,L,19,37,233122,780,267998,268778,0.2902023231068019
L19,L,19,38,167234,249,181563,181812,0.13695465645831958
L19,L,19,39,283064,39,137782,137821,0.0282975743899696
L19,L,19,4,329976,30,337114,337144,0.008898274921101961
L19,L,19,40,366626,297,404617,404914,0.07334890865714695
L19,L,19,41,164644,354,253511,253865,0.13944419277962697
L19,L,19,42,146912,1016,158732,159748,0.6360017026817236
L19,L,19,43,255158,240,304224,304464,0.07882705344474224
L19,L,19,44,457052,109,503305,503414,0.0216521590579523
L19,L,19,45,242792,129,330487,330616,0.039018075350255275
L19,L,19,46,253887,447,396801,397248,0.1125241662638956
L19,L,19,47,528554,911,720858,721769,0.12621766797964445
L19,L,19,48,172360,86,113214,113300,0.07590467784642542
L19,L,19,49,334429,1179,360560,361739,0.3259255982904801
L19,L,19,5,276550,42,194011,194053,0.021643571601572764
L19,L,19,50,314712,572,380884,381456,0.1499517637682983
L19,L,19,51,391119,81,363906,363987,0.022253542022105187
L19,L,19,52,275027,217,218410,218627,0.09925581012409264
L19,L,19,53,357603,1398,371232,372630,0.37517108123339504
L19,L,19,54,228397,50,253158,253208,0.01974661148146978
L19,L,19,55,251970,1677,239200,240877,0.6962059474337524
L19,L,19,56,117099,18,79193,79211,0.022724116599967176
L19,L,19,57,103404,202,65455,65657,0.3076595031755944
L19,L,19,58,295990,660,243627,244287,0.2701740166279826
L19,L,19,6,270685,665,199253,199918,0.33263638091617564
L19,L,19,7,314108,247,156248,156495,0.15783251861081823
L19,L,19,8,349511,85,331494,331579,0.025634916565886262
L19,L,19,9,397824,587,435497,436084,0.1346070940461012
L19,L,19,T,504477,1173,327000,328173,0.35743342688155333
L2,L,2,1,257336,2092,121668,123760,1.6903684550743374
L2,L,2,11,356797,2050,333313,335363,0.6112779286921932
L2,L,2,12,372522,420,309058,309478,0.13571239312649042
L2,L,2,13,362390,4346,239864,244210,1.7796159043446214
L2,L,2,14,210470,145,58697,58842,0.24642262329628495
L2,L,2,15,437725,287,563118,563405,0.050940264995873306
L2,L,2,16,242372,172,256351,256523,0.06705051788728496
L2,L,2,17,408489,3,90403,90406,0.0033183638254098177
L2,L,2,18,213483,619,284793,285412,0.21687945846705814
L2,L,2,19,287452,97,211346,211443,0.04587524770269056
L2,L,2,2,255030,1654,324356,326010,0.5073464004171652
L2,L,2,20,377814,95,120986,121081,0.0784598739686656
L2,L,2,21,213654,504,87542,88046,0.5724280489743997
L2,L,2,22,180068,245,121387,121632,0.20142725598526703
L2,L,2,23,157529,1,142190,142191,7.03279391803982e-4
L2,L,2,24,168006,0,107385,107385,0
L2,L,2,25,86149,4,67405,67409,0.005933925736919403
L2,L,2,26,390908,4492,236216,240708,1.866161490270369
L2,L,2,27,528470,1827,830863,832690,0.21940938404448235
L2,L,2,28,269473,588,229886,230474,0.25512639169711115
L2,L,2,29,394575,312,474309,474621,0.0657366614625143
L2,L,2,3,307409,658,272973,273631,0.24046982980729525
L2,L,2,30,235905,16,87792,87808,0.018221574344023325
L2,L,2,31,288763,186,227651,227837,0.08163731088453588
L2,L,2,32,425434,217,90949,91166,0.23802733475199087
L2,L,2,33,262953,41,253606,253647,0.016164196698561385
L2,L,2,34,286941,317,106492,106809,0.29679146888370833
L2,L,2,35,328310,428,65012,65440,0.6540342298288508
L2,L,2,36,566786,4572,574540,579112,0.7894845902001686
L2,L,2,37,575670,4151,566077,570228,0.7279544322621828
L2,L,2,38,497358,646,750958,751604,0.08594951596851534
L2,L,2,39,366468,354,215914,216268,0.16368579725155824
L2,L,2,4,291637,19,152908,152927,0.012424228553492843
L2,L,2,40,252376,29,177705,177734,0.01631651794254335
L2,L,2,41,671151,1026,766975,768001,0.1335935760500312
L2,L,2,42,405038,320,341381,341701,0.09364912599026634
L2,L,2,43,328429,353,409903,410256,0.08604383604383604
L2,L,2,44,348113,197,169088,169285,0.11637179903712673
L2,L,2,45,201188,16,112740,112756,0.01418993224307354
L2,L,2,46,427779,886,592085,592971,0.14941708785083926
L2,L,2,5,256451,418,318175,318593,0.1312018782584677
L2,L,2,6,303462,1597,454025,455622,0.3505098524654209
L2,L,2,7,228229,94,121476,121570,0.07732170765813934
L2,L,2,8,286551,13,270266,270279,0.004809844642018063
L20,L,20,1,345145,89,165666,165755,0.05369370456396489
L20,L,20,10,778630,1198,505780,506978,0.23630216695793507
L20,L,20,11,235730,96,155374,155470,0.06174824725027337
L20,L,20,12,261569,206,289880,290086,0.07101342360541356
L20,L,20,13,226711,6,145963,145969,0.004110461810384396
L20,L,20,14,162755,31,123426,123457,0.025109957313072567
L20,L,20,15,290346,195,230265,230460,0.0846133819317886
L20,L,20,16,170218,1064,86138,87202,1.2201555010206189
L20,L,20,17,259146,21899,236579,258478,8.472287776909447
L20,L,20,18,197448,825,255627,256452,0.32169762762622245
L20,L,20,19,244650,383,274392,274775,0.13938677099445002
L20,L,20,2,205908,57,85095,85152,0.0669391206313416
L20,L,20,20,247944,0,67371,67371,0
L20,L,20,21,123020,1048,52832,53880,1.945063103192279
L20,L,20,22,155021,1,75668,75669,0.0013215451505900699
L20,L,20,23,155593,43,75054,75097,0.057259278000452746
L20,L,20,24,101674,0,41516,41516,0
L20,L,20,25,196524,17,97565,97582,0.017421245721547008
L20,L,20,26,385242,111,373472,373583,0.029712272774724758
L20,L,20,27,298303,336,355393,355729,0.09445392419510358
L20,L,20,28,212639,790,158137,158927,0.4970835666689738
L20,L,20,29,158321,152,131458,131610,0.11549274371248386
L20,L,20,3,205194,20,145916,145936,0.01370463764938055
L20,L,20,30,300357,130,383933,384063,0.03384861337853425
L20,L,20,31,275200,138,347882,348020,0.039652893511867134
L20,L,20,32,276448,52,314860,314912,0.016512549537648614
L20,L,20,33,581573,1533,982101,983634,0.1558506517668157
L20,L,20,34,285322,283,194343,194626,0.14540708846711128
L20,L,20,35,164326,6,90369,90375,0.006639004149377594
L20,L,20,36,274250,266,322227,322493,0.08248241047092494
L20,L,20,37,285871,24,310848,310872,0.0077202192542268205
L20,L,20,38,319503,35,311435,311470,0.011237037274857932
L20,L,20,39,253116,235,143045,143280,0.1640145170295924
L20,L,20,4,192911,307,157912,158219,0.19403485042883598
L20,L,20,40,216429,28,82478,82506,0.033936925799335806
L20,L,20,41,124952,3,67510,67513,0.004443588642187431
L20,L,20,42,348585,1187,500678,501865,0.2365177886483417
L20,L,20,43,124152,43,120707,120750,0.03561076604554866
L20,L,20,44,130413,23,91900,91923,0.02502094144011836
L20,L,20,45,191947,733,140090,140823,0.5205115641621042
L20,L,20,46,111196,90,173258,173348,0.05191868380367815
L20,L,20,47,127198,224,176760,176984,0.1265651132305745
L20,L,20,48,182991,8,88567,88575,0.009031893875246966
L20,L,20,49,130904,41,90395,90436,0.04533592817019771
L20,L,20,5,210300,155,130132,130287,0.11896812421807242
L20,L,20,50,278409,440,317914,318354,0.13821092243226094
L20,L,20,51,228385,94,299371,299465,0.03138931093783915
L20,L,20,52,190435,33,124344,124377,0.02653223666755107
L20,L,20,53,193007,0,179619,179619,0
L20,L,20,54,215679,87,191178,191265,0.04548662849972551
L20,L,20,55,232900,146,203632,203778,0.07164659580523904
L20,L,20,56,75390,7,67172,67179,0.010419922892570594
L20,L,20,57,135124,38,150795,150833,0.025193425841825066
L20,L,20,58,247913,103,313265,313368,0.03286870388808047
L20,L,20,59,210732,181,267412,267593,0.06764003542693568
L20,L,20,6,302264,175,422593,422768,0.04139386140862128
L20,L,20,60,259354,1219,217752,218971,0.5566947221321544
L20,L,20,61,527294,323,679743,680066,0.04749539015330865
L20,L,20,62,574885,646,590113,590759,0.10935085203949496
L20,L,20,63,622479,376,556169,556545,0.06755967621665813
L20,L,20,64,629192,902,848851,849753,0.10614849256195624
L20,L,20,65,493092,57,458571,458628,0.012428373322169603
L20,L,20,66,682834,1015,993769,994784,0.1020321999549651
L20,L,20,7,365535,256,359241,359497,0.07121060815528363
L20,L,20,8,261772,4484,122976,127460,3.51796642083791
L20,L,20,9,528025,3639,443576,447215,0.8137025815323726
L20,L,20,T,427242,452,476643,477095,0.09474004129156667
L21,L,21,1,757849,530,389586,390116,0.13585702714064535
L21,L,21,10,266648,3,81505,81508,0.0036806203072091083
L21,L,21,11,233615,11,186716,186727,0.005890953102657891
L21,L,21,12,303861,53,320542,320595,0.016531761256413854
L21,L,21,13,421664,523,525864,526387,0.09935655705783009
L21,L,21,14,288444,64,279427,279491,0.02289876954893002
L21,L,21,15,412223,949,528620,529569,0.1792023324628141
L21,L,21,16,152815,3,58734,58737,0.005107513151846366
L21,L,21,17,161816,69,77035,77104,0.08948952064743723
L21,L,21,18,368837,1007,492386,493393,0.2040969369245206
L21,L,21,19,204750,90,146862,146952,0.06124448799608035
L21,L,21,2,216588,418,258443,258861,0.161476622588957
L21,L,21,20,105980,69,40444,40513,0.17031570113296965
L21,L,21,21,415162,746,516716,517462,0.14416517541384682
L21,L,21,22,152854,39,48047,48086,0.08110468743501227
L21,L,21,23,109951,90,67949,68039,0.1322770763826629
L21,L,21,24,160766,33,177161,177194,0.01862365542851338
L21,L,21,25,236100,149,213706,213855,0.06967337682074302
L21,L,21,26,188861,160,164493,164653,0.09717405695614413
L21,L,21,27,303750,5,272425,272430,0.0018353338472268106
L21,L,21,28,178458,55,121799,121854,0.04513598240517341
L21,L,21,29,355537,92,391223,391315,0.023510471103842173
L21,L,21,3,105567,274,53567,53841,0.5089058524173028
L21,L,21,30,296863,66,364967,365033,0.018080557100316957
L21,L,21,31,405948,39,527173,527212,0.007397403700977974
L21,L,21,32,329724,160,428960,429120,0.03728560775540641
L21,L,21,33,306154,69,288722,288791,0.023892711337957208
L21,L,21,34,140692,269,65231,65500,0.41068702290076337
L21,L,21,35,155179,4,96337,96341,0.004151918705431748
L21,L,21,36,105809,0,55791,55791,0
L21,L,21,37,218260,137,287353,287490,0.04765383143761522
L21,L,21,38,457175,72,348563,348635,0.02065197125934
L21,L,21,39,218727,401,264784,265185,0.15121518939608197
L21,L,21,4,249077,638,198989,199627,0.3195960466269593
L21,L,21,40,136517,143,179357,179500,0.07966573816155989
L21,L,21,41,266239,98,296856,296954,0.03300174437791712
L21,L,21,42,301877,94,192257,192351,0.048868994702393025
L21,L,21,43,115900,0,80042,80042,0
L21,L,21,44,205455,29,247380,247409,0.011721481433577598
L21,L,21,45,78636,1,130763,130764,7.647364718118136e-4
L21,L,21,46,105584,6,107300,107306,0.005591486030604067
L21,L,21,47,466015,153,356696,356849,0.042875277778556195
L21,L,21,48,157580,189,98056,98245,0.1923762023512647
L21,L,21,49,209834,0,123312,123312,0
L21,L,21,5,441837,248,322779,323027,0.07677376813702878
L21,L,21,50,305852,186,297398,297584,0.0625033603957202
L21,L,21,51,189800,94,191844,191938,0.04897414790192667
L21,L,21,52,128036,0,80042,80042,0
L21,L,21,53,216452,14,171362,171376,0.008169171879376342
L21,L,21,54,147592,25,132509,132534,0.018863084189717355
L21,L,21,55,174206,0,105920,105920,0
L21,L,21,56,148875,543,225022,225565,0.24072883647729038
L21,L,21,57,516810,790,615400,616190,0.12820720881546277
L21,L,21,58,239986,481,257956,258437,0.18611886068945235
L21,L,21,59,176961,159,228480,228639,0.06954194166349573
L21,L,21,6,206046,169,141770,141939,0.1190652322476557
L21,L,21,60,296611,598,301207,301805,0.19814118387700666
L21,L,21,61,206332,371,314181,314552,0.11794552252091864
L21,L,21,62,147328,285,199487,199772,0.14266263540436097
L21,L,21,63,252605,341,324536,324877,0.10496280130634056
L21,L,21,7,414843,41,367068,367109,0.011168345096415507
L21,L,21,8,466435,80,609517,609597,0.013123424163832827
L21,L,21,9,214652,86,133418,133504,0.06441754554170662
L21,L,21,T,414360,338,338962,339300,0.0996168582375479
L3,L,3,1,355402,143,478362,478505,0.029884745195974966
L3,L,3,10,459388,88,523090,523178,0.01682027914017791
L3,L,3,11,254354,515,175484,175999,0.2926152989505622
L3,L,3,12,354014,401,360477,360878,0.11111788471450186
L3,L,3,13,569521,468,648475,648943,0.07211727378213495
L3,L,3,14,659638,307,558519,558826,0.05493659922766657
L3,L,3,15,412854,513,395697,396210,0.12947679260997957
L3,L,3,16,333254,271,281373,281644,0.09622076096064536
L3,L,3,17,337429,637,276832,277469,0.22957519578763755
L3,L,3,18,282518,78,90294,90372,0.08630991900146062
L3,L,3,19,264277,423,108190,108613,0.3894561424507195
L3,L,3,2,323505,1139,488982,490121,0.23239159309639867
L3,L,3,20,464061,541,400073,400614,0.13504270944100807
L3,L,3,21,492638,416,371621,372037,0.11181683542228327
L3,L,3,22,246772,560,276308,276868,0.20226244997616194
L3,L,3,23,118269,181,92222,92403,0.19588108611192276
L3,L,3,24,254701,2465,323400,325865,0.7564482224233962
L3,L,3,25,250196,122,93762,93884,0.12994759490435004
L3,L,3,26,385907,955,418457,419412,0.22769973200576044
L3,L,3,27,412250,181,541174,541355,0.03343462238272483
L3,L,3,28,357736,58,619208,619266,0.009365926758452749
L3,L,3,29,457899,11,417565,417576,0.0026342510105944786
L3,L,3,3,243188,246,257364,257610,0.09549318737626644
L3,L,3,30,246030,23,159667,159690,0.01440290562965746
L3,L,3,31,158067,287,157938,158225,0.18138726497076949
L3,L,3,32,176940,163,92712,92875,0.17550471063257064
L3,L,3,33,132311,23,114551,114574,0.020074362420793548
L3,L,3,34,212870,524,219276,219800,0.2383985441310282
L3,L,3,35,370065,608,401487,402095,0.15120804784938882
L3,L,3,36,189807,282,156023,156305,0.1804164933943252
L3,L,3,37,120358,6,66782,66788,0.008983649757441457
L3,L,3,38,177912,227,188161,188388,0.12049599762192921
L3,L,3,39,373257,334,524824,525158,0.06359990707558487
L3,L,3,4,149798,154,53294,53448,0.28813051938332584
L3,L,3,40,230026,33,153845,153878,0.021445560768920836
L3,L,3,41,364468,926,413706,414632,0.22333056782882169
L3,L,3,42,307833,808,457041,457849,0.17647739756994119
L3,L,3,43,275391,172,349391,349563,0.04920429221628147
L3,L,3,44,253260,55,122081,122136,0.045031767865330447
L3,L,3,45,378054,453,488193,488646,0.09270514851242004
L3,L,3,46,390756,156,570804,570960,0.0273224043715847
L3,L,3,47,183189,41,294562,294603,0.013917034110311165
L3,L,3,48,243894,162,376815,376977,0.04297344400321505
L3,L,3,49,222111,20,68269,68289,0.029287293707624944
L3,L,3,5,177367,390,220043,220433,0.17692450767353346
L3,L,3,50,357948,496,543380,543876,0.09119725819855996
L3,L,3,51,362907,885,541387,542272,0.1632022306148944
L3,L,3,52,155911,40,79599,79639,0.050226647747962684
L3,L,3,53,221152,205,193328,193533,0.1059250877111397
L3,L,3,54,242656,275,117463,117738,0.23356945081452035
L3,L,3,55,184599,86,70635,70721,0.12160461531935353
L3,L,3,56,162587,496,156834,157330,0.31526091654484206
L3,L,3,57,477840,783,414077,414860,0.1887383695704575
L3,L,3,58,261300,296,186904,187200,0.15811965811965814
L3,L,3,59,287364,120,161016,161136,0.07447125409591898
L3,L,3,6,99232,2,48450,48452,0.0041277965821844296
L3,L,3,60,173960,96,99444,99540,0.09644364074743822
L3,L,3,61,237807,37,189441,189478,0.019527332988526373
L3,L,3,62,257306,210,269776,269986,0.07778181090871379
L3,L,3,63,223921,42,46003,46045,0.0912151156477359
L3,L,3,64,185339,68,106073,106141,0.06406572389557287
L3,L,3,65,666269,1487,683412,684899,0.21711230414995494
L3,L,3,66,349983,345,441992,442337,0.07799483199461045
L3,L,3,67,597374,90,480834,480924,0.01871397559697582
L3,L,3,68,260244,67,119244,119311,0.05615576099437604
L3,L,3,7,107396,137,61517,61654,0.2222078048464009
L3,L,3,8,359520,445,298649,299094,0.1487826569573445
L3,L,3,9,326527,230,383463,383693,0.05994375711832116
L4,L,4,1,360778,479,163727,164206,0.2917067585837302
L4,L,4,10,369712,143,484984,485127,0.02947681741069864
L4,L,4,11,437641,5,598560,598565,8.353311670411735e-4
L4,L,4,12,289860,345,188955,189300,0.18225039619651348
L4,L,4,13,130896,461,77397,77858,0.5921035731716715
L4,L,4,14,287740,1533,242517,244050,0.6281499692685926
L4,L,4,15,463259,125,682868,682993,0.018301798115061208
L4,L,4,16,217088,766,191053,191819,0.39933478956724827
L4,L,4,17,186049,48,100806,100854,0.047593551073829496
L4,L,4,18,205774,26,164472,164498,0.015805663290739097
L4,L,4,19,174725,139,211536,211675,0.06566670603519546
L4,L,4,2,204181,353,256229,256582,0.13757785035583167
L4,L,4,20,444120,1017,509131,510148,0.199353912982115
L4,L,4,21,241017,26,194743,194769,0.013349146938167777
L4,L,4,22,228392,378,207016,207394,0.18226178192233142
L4,L,4,23,193800,74,153577,153651,0.04816109234564044
L4,L,4,24,456857,3558,546697,550255,0.6466092993248584
L4,L,4,25,186530,41,81998,82039,0.049976230817050424
L4,L,4,26,415497,94,424622,424716,0.022132436734194145
L4,L,4,27,321152,228,245185,245413,0.09290461385501175
L4,L,4,28,147315,0,76909,76909,0
L4,L,4,29,149776,105,74343,74448,0.1410380399742102
L4,L,4,3,262623,208,197932,198140,0.10497627939840518
L4,L,4,30,109895,119,47486,47605,0.24997374225396493
L4,L,4,31,187697,1005,125206,126211,0.7962855852500971
L4,L,4,32,212087,107,101714,101821,0.10508637707349172
L4,L,4,33,154659,265,158984,159249,0.16640606848394654
L4,L,4,34,200026,38,209084,209122,0.018171211063398397
L4,L,4,35,309450,0,99698,99698,0
L4,L,4,36,323130,135,374329,374464,0.03605152965305076
L4,L,4,37,210260,286,170040,170326,0.16791329568004884
L4,L,4,38,212296,33,235879,235912,0.013988266811353386
L4,L,4,39,266000,17,383771,383788,0.0044295288023596365
L4,L,4,4,148952,335,101873,102208,0.3277629931120852
L4,L,4,40,145016,2,63674,63676,0.0031409008103524087
L4,L,4,41,230081,1764,181405,183169,0.9630450567508695
L4,L,4,42,352402,2699,258909,261608,1.0316962784012722
L4,L,4,43,332276,490,332124,332614,0.147317912054213
L4,L,4,44,504217,90,468626,468716,0.01920139274102015
L4,L,4,45,269941,65,221378,221443,0.029352926035142227
L4,L,4,46,513999,58,692813,692871,0.0083709666012865315
L4,L,4,47,304925,14,147807,147821,0.009470914146163266
L4,L,4,48,381678,1682,87106,88788,1.8944001441636258
L4,L,4,49,369231,201,368658,368859,0.054492367002025165
L4,L,4,5,292025,1743,370564,372307,0.46816202757401826
L4,L,4,50,459516,1319,620905,622224,0.21198153719560803
L4,L,4,51,325231,32,453327,453359,0.007058423898058713
L4,L,4,52,403044,395,545194,545589,0.07239882035744856
L4,L,4,53,215629,2,154929,154931,0.001290897238125359
L4,L,4,54,285514,74,415912,415986,0.017789060208757024
L4,L,4,55,333582,292,471222,471514,0.06192817180401854
L4,L,4,56,203531,17,135818,135835,0.012515183862774688
L4,L,4,57,236146,187,223183,223370,0.0837175986032144
L4,L,4,58,195154,59,164844,164903,0.035778609243009525
L4,L,4,59,132289,228,78567,78795,0.28935846183133446
L4,L,4,6,210390,637,134065,134702,0.4728957253789847
L4,L,4,60,237297,404,228505,228909,0.17648934729521337
L4,L,4,61,111568,17,55215,55232,0.030779258400926997
L4,L,4,62,112225,1258,134189,135447,0.9287765694330624
L4,L,4,63,226277,25,68514,68539,0.03647558324457608
L4,L,4,64,153949,612,156231,156843,0.390199116313766
L4,L,4,65,155482,185,111927,112112,0.16501355787070074
L4,L,4,66,193378,1346,218049,219395,0.6135053214521753
L4,L,4,67,151953,24,105868,105892,0.022664601669625657
L4,L,4,68,137470,4,120371,120375,0.003322949117341641
L4,L,4,69,297963,222,409217,409439,0.05422053101927271
L4,L,4,7,372035,44,436785,436829,0.010072591334366537
L4,L,4,70,143443,6,70311,70317,0.008532787234950297
L4,L,4,71,277742,23,232195,232218,0.009904486301664815
L4,L,4,72,285688,1227,291581,292808,0.41904592770689325
L4,L,4,73,201411,19,181844,181863,0.010447424709809033
L4,L,4,74,388865,141,288734,288875,0.04881003894418001
L4,L,4,75,130536,38,41874,41912,0.09066615766367628
L4,L,4,76,152291,26,122706,122732,0.021184369194668057
L4,L,4,77,202700,678,230839,231517,0.29285106493259677
L4,L,4,78,205383,41,201823,201864,0.020310704236515674
L4,L,4,79,97568,10,65597,65607,0.015242275976648834
L4,L,4,8,379211,297,258094,258391,0.11494208389611094
L4,L,4,80,118528,0,44647,44647,0
L4,L,4,81,199944,1,165767,165768,6.032527387674339e-4
L4,L,4,82,288073,39,314488,314527,0.01239957141994169
L4,L,4,83,189397,55,178020,178075,0.030885862698301278
L4,L,4,9,242491,3414,283519,286933,1.1898248023057647
L5,L,5,1,281118,666,364673,365339,0.1822964424821878
L5,L,5,10,171682,14,72324,72338,0.019353590090961874
L5,L,5,11,149424,35,59321,59356,0.0589662376170901
L5,L,5,12,208229,41,173668,173709,0.02360269185822266
L5,L,5,13,221223,19,160696,160715,0.01182216967924587
L5,L,5,14,270146,58,171966,172024,0.03371622564293354
L5,L,5,15,184775,38,97127,97165,0.039108732568311634
L5,L,5,16,369068,324,409160,409484,0.07912397065575212
L5,L,5,17,135304,60,149250,149310,0.04018485031143259
L5,L,5,18,269757,28,303315,303343,0.009230475072772406
L5,L,5,19,212228,57,203416,203473,0.02801354479464106
L5,L,5,2,185222,99,63457,63556,0.15576814148152812
L5,L,5,20,417632,384,354028,354412,0.10834847578524429
L5,L,5,21,311168,248,333263,333511,0.074360365924962
L5,L,5,22,254235,79,200352,200431,0.039415060544526544
L5,L,5,23,127959,89,48856,48945,0.18183675554193482
L5,L,5,24,190163,22,139026,139048,0.015821874460617915
L5,L,5,25,445172,313,508809,509122,0.06147838828414407
L5,L,5,26,387651,341,367948,368289,0.09259032987680871
L5,L,5,27,462130,100,534883,534983,0.018692182742255363
L5,L,5,28,248370,58,368542,368600,0.015735214324470972
L5,L,5,29,220854,50,305501,305551,0.016363880334215892
L5,L,5,3,222385,2868,166627,169495,1.6920853122510988
L5,L,5,30,415705,2026,534781,536807,0.37741683696375045
L5,L,5,31,244641,344,275923,276267,0.12451722427941085
L5,L,5,32,203521,50,274669,274719,0.018200415697494532
L5,L,5,33,152296,133,184743,184876,0.07194011120967567
L5,L,5,34,120697,1,56822,56823,0.0017598507646551572
L5,L,5,35,235323,73,168854,168927,0.04321393264546224
L5,L,5,36,264302,161,308507,308668,0.05215960190236759
L5,L,5,37,388738,98,335790,335888,0.02917639213071024
L5,L,5,38,259265,61,280840,280901,0.021715835828281137
L5,L,5,39,185340,4,111056,111060,0.003601656762110571
L5,L,5,4,232321,72,235127,235199,0.030612375052615017
L5,L,5,40,316881,199,301648,301847,0.065927440060693
L5,L,5,41,280531,20,267710,267730,0.007470212527546409
L5,L,5,42,311472,278,274420,274698,0.10120204733925983
L5,L,5,43,404024,284,403433,403717,0.07034630694273464
L5,L,5,44,435040,113,269805,269918,0.041864566275683725
L5,L,5,45,136082,0,62018,62018,0
L5,L,5,46,194840,188,183872,184060,0.10214060632402477
L5,L,5,47,223585,346,196981,197327,0.17534346541527515
L5,L,5,48,247457,870,292486,293356,0.2965679924733089
L5,L,5,49,283271,110,350499,350609,0.03137398070214969
L5,L,5,5,256298,747,291823,292570,0.25532351232183753
L5,L,5,50,150820,102,164330,164432,0.06203172131945121
L5,L,5,51,123411,18,92886,92904,0.019374838543012144
L5,L,5,52,198517,1,202636,202637,4.934932909587094e-4
L5,L,5,53,234375,205,143840,144045,0.142316637161998
L5,L,5,54,90276,121,38507,38628,0.31324427876152017
L5,L,5,55,136065,147,320192,320339,0.04588888646090548
L5,L,5,56,269859,1165,311474,312639,0.37263425228458386
L5,L,5,57,187393,2194,158202,160396,1.367864535275194
L5,L,5,58,154891,116,158575,158691,0.07309803328481136
L5,L,5,59,394009,2100,473507,475607,0.44154102021206587
L5,L,5,6,313609,4,235255,235259,0.001700253762874109
L5,L,5,60,147953,70,82617,82687,0.08465659656294218
L5,L,5,61,325861,503,264586,265089,0.18974759420421067
L5,L,5,62,301639,33,256287,256320,0.012874531835205993
L5,L,5,63,210658,363,105383,105746,0.3432753957596505
L5,L,5,64,151225,2686,87009,89695,2.9945927866659234
L5,L,5,65,185233,163,65004,65167,0.25012659781791396
L5,L,5,66,240135,1295,160126,161421,0.8022500170361972
L5,L,5,67,167566,845,80433,81278,1.039641723467605
L5,L,5,68,196888,386,86734,87120,0.4430670339761249
L5,L,5,69,124025,1351,93864,95215,1.4188940818148401
L5,L,5,7,297577,418,351357,351775,0.11882595408997229
L5,L,5,70,125080,49,105367,105416,0.04648250739925628
L5,L,5,71,100887,29,102630,102659,0.028248862739750046
L5,L,5,72,209045,58,109631,109689,0.05287676977636773
L5,L,5,73,134419,171,112860,113031,0.15128593040847202
L5,L,5,74,159761,1506,100816,102322,1.4718242411211664
L5,L,5,75,432260,63,270145,270208,0.02331537186167693
L5,L,5,76,129595,35,72540,72575,0.04822597313124354
L5,L,5,77,138116,342,127402,127744,0.2677229458917836
L5,L,5,78,314979,603,357588,358191,0.1683459383401593
L5,L,5,79,118302,10,133032,133042,0.007516423385096435
L5,L,5,8,228953,10,120359,120369,0.008307786888650732
L5,L,5,80,228639,126,208132,208258,0.06050187747889637
L5,L,5,9,142253,147,101620,101767,0.1444476107186023
L6,L,6,1,249584,409,257752,258161,0.1584282676314393
L6,L,6,10,180738,243,87477,87720,0.2770177838577291
L6,L,6,11,409921,102,330059,330161,0.030894018372854454
L6,L,6,12,246108,2,156804,156806,0.0012754613981607846
L6,L,6,13,284753,27,247006,247033,0.010929713843899399
L6,L,6,14,298230,701,338223,338924,0.20683102996541997
L6,L,6,15,198873,19,174743,174762,0.010871928680147858
L6,L,6,16,330305,1253,375018,376271,0.33300466950681823
L6,L,6,17,417347,107,289122,289229,0.03699490714969799
L6,L,6,18,380051,71,405578,405649,0.017502816474341116
L6,L,6,19,263219,829,127665,128494,0.6451663112674522
L6,L,6,2,114213,0,117562,117562,0
L6,L,6,20,298170,3562,227749,231311,1.5399181188962048
L6,L,6,21,424004,771,505913,506684,0.15216584695786722
L6,L,6,22,390065,279,258612,258891,0.10776736155370407
L6,L,6,23,260924,91,236019,236110,0.038541357841683964
L6,L,6,24,255418,298,301303,301601,0.0988060384415171
L6,L,6,25,251632,7942,199141,207083,3.835177199480402
L6,L,6,26,245299,123,164534,164657,0.0747007415415075
L6,L,6,28,313652,376,322452,322828,0.11647069027469736
L6,L,6,29,372467,380,294769,295149,0.12874853040328785
L6,L,6,3,196906,1685,191349,193034,0.8729032191220198
L6,L,6,30,178108,1224,145300,146524,0.8353580300838088
L6,L,6,31,172203,359,149526,149885,0.23951696300497047
L6,L,6,32,201644,61,57791,57852,0.10544147134066237
L6,L,6,33,140523,26,153483,153509,0.016937117693425142
L6,L,6,35,349302,79,213335,213414,0.037017252851265614
L6,L,6,37,310226,67,340539,340606,0.019670822005484343
L6,L,6,38,436933,161,386578,386739,0.04163014332663631
L6,L,6,39,316109,370,344071,344441,0.1074204290430001
L6,L,6,4,411187,2244,537988,540232,0.41537709724710864
L6,L,6,40,232704,189,169172,169361,0.11159594003341973
L6,L,6,41,233801,210,168054,168264,0.12480387961774356
L6,L,6,42,365240,47,286141,286188,0.016422771045606386
L6,L,6,43,256055,146,170918,171064,0.08534817378291167
L6,L,6,44,239021,1198,263511,264709,0.45257244748006303
L6,L,6,45,319254,858,323888,324746,0.2642064875317941
L6,L,6,46,385874,393,591901,592294,0.06635218320631307
L6,L,6,47,107627,143,58762,58905,0.24276377217553688
L6,L,6,48,193882,27,174081,174108,0.01550761596250603
L6,L,6,49,215171,213,135238,135451,0.15725243815106568
L6,L,6,5,291615,52,80933,80985,0.06420942149780824
L6,L,6,50,359728,112,248910,249022,0.04497594590036222
L6,L,6,51,354717,306,292185,292491,0.10461860364934306
L6,L,6,52,552989,288,440209,440497,0.06538069498770707
L6,L,6,53,483602,59,254864,254923,0.02314424355589727
L6,L,6,54,229606,475,136439,136914,0.3469331112961421
L6,L,6,55,300501,62,168046,168108,0.0368810526566255
L6,L,6,56,287914,0,112284,112284,0
L6,L,6,57,271119,0,129079,129079,0
L6,L,6,58,454986,170,276668,276838,0.06140775471575434
L6,L,6,59,459362,501,426217,426718,0.11740774938015269
L6,L,6,6,272474,399,262375,262774,0.151841506389521
L6,L,6,60,524763,114,492007,492121,0.023165034615470585
L6,L,6,61,419194,87,426270,426357,0.020405434882035476
L6,L,6,62,659930,219,606691,606910,0.036084427674614034
L6,L,6,63,615811,110,603451,603561,0.018225166967381922
L6,L,6,64,173644,107,99249,99356,0.10769354643906759
L6,L,6,65,621149,1668,685243,686911,0.24282621766138554
L6,L,6,66,438452,2549,422891,425440,0.5991444151936819
L6,L,6,67,487943,933,515236,516169,0.18075475280382977
L6,L,6,68,693317,369,664055,664424,0.05553682588226795
L6,L,6,69,679873,226,585301,585527,0.03859770770604942
L6,L,6,7,496235,636,638829,639465,0.09945814078956627
L6,L,6,70,724358,327,505565,505892,0.06463830224632926
L6,L,6,71,519678,587,551500,552087,0.10632382215121892
L6,L,6,8,310031,460,156225,156685,0.2935826658582506
L6,L,6,9,436777,24,513134,513158,0.0046769221175544376
L7,L,7,1,354787,9,143930,143939,0.006252648691459577
L7,L,7,10,350435,642,339951,340593,0.18849477235292564
L7,L,7,11,222622,60,105893,105953,0.056628882617764484
L7,L,7,12,293332,49,144394,144443,0.0339234161572385
L7,L,7,13,409146,78,377450,377528,0.020660719204933144
L7,L,7,14,234087,60,201105,201165,0.029826262023711875
L7,L,7,15,304170,25,238088,238113,0.010499216758429821
L7,L,7,16,606180,67,668721,668788,0.010018122334730886
L7,L,7,17,364827,808,173483,174291,0.4635924976045809
L7,L,7,18,218581,112,91267,91379,0.12256645399927772
L7,L,7,19,304014,2854,183271,186125,1.5333781061114842
L7,L,7,2,387338,380,330718,331098,0.11476964524098605
L7,L,7,20,517991,104,283265,283369,0.036701262311685474
L7,L,7,21,187959,174,104682,104856,0.16594186312657358
L7,L,7,22,419684,946,370074,371020,0.2549727777478303
L7,L,7,23,204815,0,134656,134656,0
L7,L,7,24,237731,109,161448,161557,0.0674684476686247
L7,L,7,25,391989,35,382300,382335,0.009154275700629029
L7,L,7,26,243718,213,103125,103338,0.20611972362538467
L7,L,7,27,240296,689,212611,213300,0.323019221753399
L7,L,7,28,341934,70,220181,220251,0.031781921534976006
L7,L,7,29,316695,34,216407,216441,0.015708668875120704
L7,L,7,3,516018,2,424868,424870,4.7073222397439217e-4
L7,L,7,30,391557,301,256859,257160,0.11704775237206409
L7,L,7,31,364529,284,215675,215959,0.13150644335267342
L7,L,7,32,399756,185,180547,180732,0.10236150764668128
L7,L,7,33,385390,16,168007,168023,0.009522505847413747
L7,L,7,34,281443,200,250889,251089,0.07965303139524232
L7,L,7,35,232933,1,101133,101134,9.887871536772995e-4
L7,L,7,36,399104,713,307506,308219,0.2313290225456575
L7,L,7,37,222402,741,66027,66768,1.1098130841121494
L7,L,7,38,246994,53,42123,42176,0.1256638846737481
L7,L,7,39,162158,28,60440,60468,0.046305483892306674
L7,L,7,4,363340,121,384412,384533,0.03146674017574564
L7,L,7,40,222701,294,189460,189754,0.15493744532394574
L7,L,7,41,209550,13,42129,42142,0.03084808504579754
L7,L,7,42,300852,46,182186,182232,0.025242547960841126
L7,L,7,43,327745,0,453796,453796,0
L7,L,7,44,665200,1657,344227,345884,0.4790623446010801
L7,L,7,45,452860,828,153620,154448,0.5361027659794882
L7,L,7,46,285446,0,42490,42490,0
L7,L,7,47,343185,24,179511,179535,0.013367866989723453
L7,L,7,48,273637,62,127281,127343,0.048687403312313984
L7,L,7,49,231343,2268,278253,280521,0.8084956206487215
L7,L,7,5,413254,52,209974,210026,0.024758839381790826
L7,L,7,50,215541,211,244846,245057,0.0861024169887006
L7,L,7,51,523476,307,599192,599499,0.05120942653782575
L7,L,7,52,181438,0,144762,144762,0
L7,L,7,53,310798,0,76738,76738,0
L7,L,7,54,333397,883,398968,399851,0.2208322600168563
L7,L,7,55,170518,61,73793,73854,0.08259539090638286
L7,L,7,56,158502,293,99373,99666,0.29398189954447856
L7,L,7,57,256439,147,218614,218761,0.06719662096991695
L7,L,7,58,350511,237,411876,412113,0.05750849888258802
L7,L,7,59,342143,415,463992,464407,0.08936127147092959
L7,L,7,6,345814,46,277420,277466,0.016578607829427747
L7,L,7,60,293169,284,262999,263283,0.10786871921088714
L7,L,7,61,214290,0,113604,113604,0
L7,L,7,62,211936,2290,153454,155744,1.470361619067187
L7,L,7,63,144731,952,93354,94306,1.0094797785930907
L7,L,7,64,330692,52,336914,336966,0.015431823982241532
L7,L,7,65,199263,578,139547,140125,0.41248884924174845
L7,L,7,66,75791,57,66596,66653,0.08551753109387425
L7,L,7,67,331323,110,593519,593629,0.018530092027175222
L7,L,7,7,390621,45,232614,232659,0.019341611543073768
L7,L,7,8,574522,68,545280,545348,0.012469102297982206
L7,L,7,9,569753,109,486492,486601,0.022400282777881673
L8,L,8,1,206891,108,65697,65805,0.1641212673808981
L8,L,8,10,364542,340,386186,386526,0.0879630348281875
L8,L,8,11,554535,1316,639484,640800,0.20536828963795256
L8,L,8,12,311857,195,289868,290063,0.06722677487304482
L8,L,8,13,179784,174,110904,111078,0.15664668071085183
L8,L,8,14,116725,131,47810,47941,0.2732525395799003
L8,L,8,15,205509,675,121749,122424,0.5513624779455009
L8,L,8,16,191081,600,114589,115189,0.5208830704320725
L8,L,8,17,275545,2912,252931,255843,1.1381980355139676
L8,L,8,18,186875,2037,259232,261269,0.7796562163900042
L8,L,8,19,385111,1768,269903,271671,0.6507871653580986
L8,L,8,2,156269,45,77216,77261,0.05824413352144032
L8,L,8,20,375473,1438,349521,350959,0.4097344704082243
L8,L,8,21,318772,124,214588,214712,0.05775177912738925
L8,L,8,22,217304,2333,99428,101761,2.2926268413242794
L8,L,8,23,199703,2691,137242,139933,1.9230631802362559
L8,L,8,24,212379,2327,175027,177354,1.3120651352661907
L8,L,8,25,152702,968,52970,53938,1.7946531202491751
L8,L,8,26,165497,153,124570,124723,0.12267184079921105
L8,L,8,27,208979,6,163726,163732,0.0036645249554149465
L8,L,8,28,406660,170,308651,308821,0.05504806991752503
L8,L,8,29,238476,63,110277,110340,0.057096247960848286
L8,L,8,3,207394,120,100255,100375,0.1195516811955168
L8,L,8,30,149444,93,99909,100002,0.09299814003719926
L8,L,8,31,193419,327,146724,147051,0.22237183018136564
L8,L,8,32,242427,1,98042,98043,0.0010199606295197006
L8,L,8,33,378132,240,377253,377493,0.06357733785792055
L8,L,8,34,187264,186,117350,117536,0.1582493874217261
L8,L,8,35,208127,201,250396,250597,0.08020846219228484
L8,L,8,36,225394,102,126881,126983,0.08032571289070191
L8,L,8,37,130271,1044,47857,48901,2.134925666141797
L8,L,8,38,144657,1,86150,86151,0.001160752632006593
L8,L,8,39,160218,444,162126,162570,0.27311312050193765
L8,L,8,4,190148,1818,155540,157358,1.1553273427471118
L8,L,8,40,241501,398,207107,207505,0.1918026071660924
L8,L,8,41,297779,331,280364,280695,0.11792158748819893
L8,L,8,42,162187,48,132795,132843,0.036132878661276846
L8,L,8,43,224363,10,237720,237730,0.0042064526984394056
L8,L,8,44,329644,337,307313,307650,0.10954006175849179
L8,L,8,45,143597,60,118437,118497,0.050634193270715715
L8,L,8,46,154997,685,51118,51803,1.3223172403142676
L8,L,8,47,236971,36,159389,159425,0.02258115101144739
L8,L,8,48,208473,118,171461,171579,0.06877298503896165
L8,L,8,49,296843,19,83190,83209,0.022834068430097706
L8,L,8,5,250488,719,191993,192712,0.37309560380256546
L8,L,8,50,324190,308,277745,278053,0.11077024883745185
L8,L,8,51,230814,119,215467,215586,0.055198389505812066
L8,L,8,52,221483,2355,162398,164753,1.42941251449139
L8,L,8,53,218563,965,334872,335837,0.287341775921057
L8,L,8,54,333472,1217,283775,284992,0.42702953065349203
L8,L,8,55,226546,2975,98499,101474,2.931785481995388
L8,L,8,56,279552,268,226226,226494,0.11832543025422307
L8,L,8,57,343683,83,162280,162363,0.05112002118709312
L8,L,8,6,156994,19,122290,122309,0.015534425103630968
L8,L,8,7,159532,397,169300,169697,0.23394638679528806
L8,L,8,8,265399,201,109316,109517,0.18353315010454999
L9,L,9,1,255471,209,130636,130845,0.15973097940311054
L9,L,9,10,382425,2133,420510,422643,0.5046812558116424
L9,L,9,11,265554,113,140203,140316,0.08053251232931384
L9,L,9,12,345554,1072,396288,397360,0.2697805516408295
L9,L,9,13,379404,33,363477,363510,0.009078154658743913
L9,L,9,14,592260,422,472602,473024,0.0892132323095657
L9,L,9,15,294405,190,169359,169549,0.112061999775876
L9,L,9,16,391867,1089,489149,490238,0.2221370028435168
L9,L,9,17,117207,109,39763,39872,0.27337479935794545
L9,L,9,18,286119,832,311345,312177,0.2665154703901953
L9,L,9,19,182906,333,199426,199759,0.16670087455383736
L9,L,9,2,283769,586,350097,350683,0.16710248286914395
L9,L,9,20,130623,57,41841,41898,0.13604467993698985
L9,L,9,21,167767,89,181594,181683,0.048986421404314105
L9,L,9,22,228772,439,223549,223988,0.1959926424629891
L9,L,9,23,174928,23,129189,129212,0.017800204315388663
L9,L,9,24,235297,268,269083,269351,0.09949842398951554
L9,L,9,25,279014,143,225491,225634,0.06337697332848773
L9,L,9,26,349484,115,190049,190164,0.06047411707789067
L9,L,9,27,365514,339,241349,241688,0.14026348018933502
L9,L,9,28,293166,533,109473,110006,0.48451902623493265
L9,L,9,29,163047,116,60533,60649,0.19126448910946595
L9,L,9,3,218744,39,147648,147687,0.02640719900871438
L9,L,9,30,175275,1585,69764,71349,2.2214747228412453
L9,L,9,31,249519,325,208526,208851,0.15561333199266464
L9,L,9,32,193856,2541,78395,80936,3.1395176435702283
L9,L,9,33,191636,40,83116,83156,0.04810236182596565
L9,L,9,34,195264,815,275176,275991,0.2952994844034769
L9,L,9,35,353791,519,257258,257777,0.20133681437831927
L9,L,9,36,303202,49,224752,224801,0.021797056062917868
L9,L,9,37,224194,22,191800,191822,0.01146896602058158
L9,L,9,38,196461,99,180568,180667,0.05479694686910171
L9,L,9,39,279397,24,199254,199278,0.012043476951795983
L9,L,9,4,311350,141,386189,386330,0.03649729505862863
L9,L,9,40,302697,303,299640,299943,0.10101919364679289
L9,L,9,41,146052,0,49682,49682,0
L9,L,9,42,235553,46,233841,233887,0.019667617268167962
L9,L,9,43,223730,2,68336,68338,0.0029266294009189617
L9,L,9,44,387989,240,415633,415873,0.057709925866791065
L9,L,9,45,287089,29,230550,230579,0.012577034335303737
L9,L,9,46,400096,132,366182,366314,0.03603465878999984
L9,L,9,47,257153,26,142649,142675,0.01822323462414579
L9,L,9,48,503174,695,455369,456064,0.1523908925063149
L9,L,9,49,306331,140,184074,184214,0.07599856688416733
L9,L,9,5,259593,122,174013,174135,0.07006058517816637
L9,L,9,50,169294,10175,38455,48630,20.92329837548838
L9,L,9,51,169670,453,49642,50095,0.9042818644575308
L9,L,9,52,161690,148,73236,73384,0.2016788400741306
L9,L,9,53,251457,131,205726,205857,0.06363640779764594
L9,L,9,55,315431,325,168119,168444,0.19294246158960843
L9,L,9,56,241512,496,130212,130708,0.37947179973681794
L9,L,9,58,417131,226,365638,365864,0.061771587256466885
L9,L,9,59,498990,218,549858,550076,0.03963088736829093
L9,L,9,6,280557,130,276881,277011,0.04692954431412471
L9,L,9,60,405899,194,406539,406733,0.047697137925862915
L9,L,9,7,212484,60,137286,137346,0.0436852911624656
L9,L,9,8,177063,57,106030,106087,0.05372948617644009
L9,L,9,9,292253,230,289061,289291,0.07950472016066866
